,Year,Rank,Movie,Worldwide,Domestic,%Domestic,Foreign,%Foreign
0,2019,1,Avengers: Endgame,2797800564 ,858373000 ,30.70,1939427564 ,69.30
1,2019,2,The Lion King,1655146969 ,543486894 ,32.80,1111660075 ,67.20
2,2019,3,Spider-Man: Far From Home,1131845802 ,390532085 ,34.50,741313717 ,65.50
3,2019,4,Captain Marvel,1128274794 ,426829839 ,37.80,701444955 ,62.20
4,2019,5,Toy Story 4,1073163682 ,433952080 ,40.40,639211602 ,59.60
5,2019,6,Aladdin,1050693953 ,355559216 ,33.80,695134737 ,66.20
6,2019,7,Joker,988735635 ,315735635 ,31.90,673000000 ,68.10
7,2019,8,Fast & Furious Presents: Hobbs & Shaw,758910100 ,173810100 ,22.90,585100000 ,77.10
8,2019,9,Ne Zha,700547754 ,3695533 ,0.50,696852221 ,99.50
9,2019,10,The Wandering Earth,699760773 ,5875487 ,0.80,693885286 ,99.20
10,2019,11,How to Train Your Dragon: The Hidden World,519896648 ,160799505 ,30.90,359097143 ,69.10
11,2019,12,It Chapter Two,462519656 ,211419656 ,45.70,251100000 ,54.30
12,2019,13,Maleficent: Mistress of Evil,434181232 ,100012127 ,23,334169105 ,77
13,2019,14,Pok√©mon Detective Pikachu,431705346 ,144105346 ,33.40,287600000 ,66.60
14,2019,15,The Secret Life of Pets 2,429434163 ,158257265 ,36.90,271176898 ,63.10
15,2019,16,"My People, My Country",420105485 ,2356683 ,0.60,417748802 ,99.40
16,2019,17,The Captain,407664445 ,702899 ,0.20,406961546 ,99.80
17,2019,18,Alita: Battle Angel,404852543 ,85710210 ,21.20,319142333 ,78.80
18,2019,19,Godzilla: King of the Monsters,385900138 ,110500138 ,28.60,275400000 ,71.40
19,2019,20,Once Upon a Time... in Hollywood,371192152 ,140878766 ,38,230313386 ,62
20,2019,21,Shazam!,364571656 ,140371656 ,38.50,224200000 ,61.50
21,2019,22,Dumbo,353284621 ,114766307 ,32.50,238518314 ,67.50
22,2019,23,John Wick: Chapter 3 - Parabellum,326667460 ,171015687 ,52.40,155651773 ,47.60
23,2019,24,Us,255105930 ,175005930 ,68.60,80100000 ,31.40
24,2019,25,Men in Black: International,253890701 ,80001807 ,31.50,173888894 ,68.50
25,2019,26,Dark Phoenix,252442974 ,65845974 ,26.10,186597000 ,73.90
26,2019,27,Glass,246985576 ,111035005 ,45,135950571 ,55
27,2019,28,The Bravest,238004304 ,290217 ,0.10,237714087 ,99.90
28,2019,29,Annabelle Comes Home,228552591 ,74152591 ,32.40,154400000 ,67.60
29,2019,30,Terminator: Dark Fate,202941367 ,51164755 ,25.20,151776612 ,74.80
30,2019,31,Better Days,198809935 ,989536 ,0.50,197820399 ,99.50
31,2019,32,Rocketman,195179299 ,96368160 ,49.40,98811139 ,50.60
32,2019,33,The Lego Movie 2: The Second Part,191306508 ,105806508 ,55.30,85500000 ,44.70
33,2019,34,The White Storm 2: Drug Lords,188092373 ,609461 ,0.30,187482912 ,99.70
34,2019,35,Downton Abbey,182050075 ,95850075 ,52.70,86200000 ,47.30
35,2019,36,Gemini Man,169257846 ,48135938 ,28.40,121121908 ,71.60
36,2019,37,Abominable,167457510 ,59357510 ,35.40,108100000 ,64.60
37,2019,38,The Addams Family,156747127 ,92647127 ,59.10,64100000 ,40.90
38,2019,39,Escape Room,155712077 ,57005601 ,36.60,98706476 ,63.40
39,2019,40,The Climbers,153782355 ,487157 ,0.30,153295198 ,99.70
40,2019,41,Yesterday,151286650 ,73286650 ,48.40,78000000 ,51.60
41,2019,42,The Angry Birds Movie 2,145678023 ,41657076 ,28.60,104020947 ,71.40
42,2019,43,Hustlers,144990084 ,104690084 ,72.20,40300000 ,27.80
43,2019,44,Angel Has Fallen,133365452 ,69030436 ,51.80,64335016 ,48.20
44,2019,45,Ad Astra,126992864 ,50005312 ,39.40,76987552 ,60.60
45,2019,46,Looking Up,122994583 ,84267 ,<0.1,122910316 ,99.90
46,2019,47,The Upside,122752517 ,108252517 ,88.20,14500000 ,11.80
47,2019,48,The Curse of La Llorona,122133739 ,54733739 ,44.80,67400000 ,55.20
48,2019,49,Extreme Job,119932733 ,1565885 ,1.30,118366848 ,98.70
49,2019,50,Wonder Park,119559110 ,45216793 ,37.80,74342317 ,62.20
50,2019,51,P Storm,117991727 ,326711 ,0.30,117665016 ,99.70
51,2019,52,Dora and the Lost City of Gold,116826172 ,60477943 ,51.80,56348229 ,48.20
52,2019,53,Pet Sematary,112399944 ,54724696 ,48.70,57675248 ,51.30
53,2019,54,Good Boys,110883070 ,83083070 ,74.90,27800000 ,25.10
54,2019,55,Parasite,107493062 ,11318741 ,10.50,96174321 ,89.50
55,2019,56,Zombieland: Double Tap,102825907 ,67763112 ,65.90,35062795 ,34.10
56,2019,57,Line Walker 2: Invisible Spy,99482027 ,296751 ,0.30,99185276 ,99.70
57,2019,58,Scary Stories to Tell in the Dark,95677760 ,68947075 ,72.10,26730685 ,27.90
58,2019,59,The Hustle,95017038 ,35417038 ,37.30,59600000 ,62.70
59,2019,60,Five Feet Apart,91528689 ,45729221 ,50,45799468 ,50
60,2019,61,Crawl,90510445 ,39014193 ,43.10,51496252 ,56.90
61,2019,62,Rambo: Last Blood,86967911 ,44745467 ,51.50,42222444 ,48.50
62,2019,63,One Piece: Stampede,79885414 ,1298528 ,1.60,78586886 ,98.40
63,2019,64,Cold Pursuit,76419755 ,32138862 ,42.10,44280893 ,57.90
64,2019,65,A Dog's Way Home,76087556 ,42004346 ,55.20,34083210 ,44.80
65,2019,66,A Madea Family Funeral,74747725 ,73257045 ,98,1490680 ,2
66,2019,67,What Men Want,72216294 ,54611903 ,75.60,17604391 ,24.40
67,2019,68,A Dog's Journey,71746590 ,22546590 ,31.40,49200000 ,68.60
68,2019,69,Exit,69869487 ,470699 ,0.70,69398788 ,99.30
69,2019,70,After,69497587 ,12138565 ,17.50,57359022 ,82.50
70,2019,71,War,67179155 ,4654000 ,6.90,62525155 ,93.10
71,2019,72,Happy Death Day 2U,64503067 ,28051045 ,43.50,36452022 ,56.50
72,2019,73,Ma,60582764 ,45373120 ,74.90,15209644 ,25.10
73,2019,74,Ready or Not,57147559 ,28714231 ,50.20,28433328 ,49.80
74,2019,75,Long Shot,53410558 ,30316271 ,56.80,23094287 ,43.20
75,2019,76,Breakthrough,50444358 ,40713082 ,80.70,9731276 ,19.30
76,2019,77,Little,48800575 ,40673960 ,83.30,8126615 ,16.70
77,2019,78,Isn't It Romantic,48791187 ,48791187 ,100,,
78,2019,79,Chasing the Dragon II: Wild Wild Bunch,45733356 ,196634 ,0.40,45536722 ,99.60
79,2019,80,Child's Play,44902237 ,29208403 ,65,15693834 ,35
80,2019,81,Hellboy,44664690 ,21903748 ,49,22760942 ,51
81,2019,82,Midway,42186561 ,23574563 ,55.90,18611998 ,44.10
82,2019,83,Midsommar,41084036 ,27426361 ,66.80,13657675 ,33.20
83,2019,84,Fighting with My Family,39058886 ,22958886 ,58.80,16100000 ,41.20
84,2019,85,47 Meters Down: Uncaged,38912179 ,22260746 ,57.20,16651433 ,42.80
85,2019,86,Doctor Sleep,36695840 ,17195840 ,46.90,19500000 ,53.10
86,2019,87,The Intruder,36599361 ,35419122 ,96.80,1180239 ,3.20
87,2019,88,Overcomer,35708893 ,34700142 ,97.20,1008751 ,2.80
88,2019,89,Judy,35442585 ,23488450 ,66.30,11954135 ,33.70
89,2019,90,Pain & Glory,34193642 ,2793642 ,8.20,31400000 ,91.80
90,2019,91,Bad Guys: The Movie,34024386 ,166972 ,0.50,33857414 ,99.50
91,2019,92,The Art of Racing in the Rain,33766787 ,26395642 ,78.20,7371145 ,21.80
92,2019,93,Brightburn,32893421 ,17300439 ,52.60,15592982 ,47.40
93,2019,94,UglyDolls,32450241 ,20150241 ,62.10,12300000 ,37.90
94,2019,95,Stuber,32390945 ,22370452 ,69.10,10020493 ,30.90
95,2019,96,The Kid Who Would Be King,32140970 ,16790790 ,52.20,15350180 ,47.80
96,2019,97,Anna,30918726 ,7743794 ,25,23174932 ,75
97,2019,98,Countdown,28330051 ,22910051 ,80.90,5420000 ,19.10
98,2019,99,No manches Frida 2,26493648 ,9270920 ,35,17222728 ,65
99,2019,100,Missing Link,26249469 ,16649539 ,63.40,9599930 ,36.60
100,2018,1,Avengers: Infinity War,2048359754 ,678815482 ,33.10,1369544272 ,66.90
101,2018,2,Black Panther,1346913161 ,700059566 ,52,646853595 ,48
102,2018,3,Jurassic World: Fallen Kingdom,1308467944 ,417719760 ,31.90,890748184 ,68.10
103,2018,4,Incredibles 2,1242805359 ,608581744 ,49,634223615 ,51
104,2018,5,Aquaman,1148161807 ,335061807 ,29.20,813100000 ,70.80
105,2018,6,Bohemian Rhapsody,903655259 ,216428042 ,24,687227217 ,76
106,2018,7,Venom,856085151 ,213515506 ,24.90,642569645 ,75.10
107,2018,8,Mission: Impossible - Fallout,791115104 ,220159104 ,27.80,570956000 ,72.20
108,2018,9,Deadpool 2,734546611 ,318491426 ,43.40,416055185 ,56.60
109,2018,10,Fantastic Beasts: The Crimes of Grindelwald,653755901 ,159555901 ,24.40,494200000 ,75.60
110,2018,11,Ant-Man and the Wasp,622674139 ,216648740 ,34.80,406025399 ,65.20
111,2018,12,Ready Player One,582890172 ,137690172 ,23.60,445200000 ,76.40
112,2018,13,Operation Red Sea,579220560 ,1543547 ,0.30,577677013 ,99.70
113,2018,14,Detective Chinatown 2,544061916 ,1983984 ,0.40,542077932 ,99.60
114,2018,15,The Meg,530243742 ,145443742 ,27.40,384800000 ,72.60
115,2018,16,Ralph Breaks the Internet,529323962 ,201091711 ,38,328232251 ,62
116,2018,17,Hotel Transylvania 3: Summer Vacation,528583774 ,167510016 ,31.70,361073758 ,68.30
117,2018,18,The Grinch,511595957 ,270620950 ,52.90,240975007 ,47.10
118,2018,19,Bumblebee,467989645 ,127195589 ,27.20,340794056 ,72.80
119,2018,20,A Star Is Born,434888866 ,215288866 ,49.50,219600000 ,50.50
120,2018,21,Rampage,428028233 ,101028233 ,23.60,327000000 ,76.40
121,2018,22,Mamma Mia! Here We Go Again,395044706 ,120634935 ,30.50,274409771 ,69.50
122,2018,23,Solo: A Star Wars Story,392924807 ,213767512 ,54.40,179157295 ,45.60
123,2018,24,Spider-Man: Into the Spider-Verse,375540831 ,190241310 ,50.70,185299521 ,49.30
124,2018,25,Fifty Shades Freed,371985018 ,100407760 ,27,271577258 ,73
125,2018,26,The Nun,365550119 ,117450119 ,32.10,248100000 ,67.90
126,2018,27,Monster Hunt 2,361682618 ,706153 ,0.20,360976465 ,99.80
127,2018,28,Peter Rabbit,351266433 ,115253424 ,32.80,236013009 ,67.20
128,2018,29,Mary Poppins Returns,349537494 ,171958438 ,49.20,177579056 ,50.80
129,2018,30,A Quiet Place,340939361 ,188024361 ,55.10,152915000 ,44.90
130,2018,31,Green Book,321752656 ,85080171 ,26.40,236672485 ,73.60
131,2018,32,Skyscraper,304868961 ,68420120 ,22.40,236448841 ,77.60
132,2018,33,Ocean's Eight,297718711 ,140218711 ,47.10,157500000 ,52.90
133,2018,34,Pacific Rim: Uprising,290930148 ,59874525 ,20.60,231055623 ,79.40
134,2018,35,Maze Runner: The Death Cure,288175335 ,58032443 ,20.10,230142892 ,79.90
135,2018,36,Tomb Raider,274650803 ,58250803 ,21.20,216400000 ,78.80
136,2018,37,Halloween,255485178 ,159342015 ,62.40,96143163 ,37.60
137,2018,38,Crazy Rich Asians,238532921 ,174532921 ,73.20,64000000 ,26.80
138,2018,39,Creed II,214115889 ,115715889 ,54,98400000 ,46
139,2018,40,Smallfoot,214040103 ,83240103 ,38.90,130800000 ,61.10
140,2018,41,The Island,198326350 ,670883 ,0.30,197655467 ,99.70
141,2018,42,Christopher Robin,197744377 ,99215042 ,50.20,98529335 ,49.80
142,2018,43,The Equalizer 2,190400157 ,102084362 ,53.60,88315795 ,46.40
143,2018,44,The Mule,174504407 ,103804407 ,59.50,70700000 ,40.50
144,2018,45,The Nutcracker and the Four Realms,173961069 ,54858851 ,31.50,119102218 ,68.50
145,2018,46,Insidious: The Last Key,167885588 ,67745330 ,40.40,100140258 ,59.60
146,2018,47,The Predator,160542134 ,51024708 ,31.80,109517426 ,68.20
147,2018,48,Johnny English Strikes Again,158970776 ,4412170 ,2.80,154558606 ,97.20
148,2018,49,Red Sparrow,151572634 ,46874505 ,30.90,104698129 ,69.10
149,2018,50,More Than Blue,142958164 ,722669 ,0.50,142235495 ,99.50
150,2018,51,The First Purge,137056262 ,69488745 ,50.70,67567517 ,49.30
151,2018,52,A Wrinkle in Time,132675864 ,100478608 ,75.70,32197256 ,24.30
152,2018,53,The House with a Clock in Its Walls,131457147 ,68549695 ,52.10,62907452 ,47.90
153,2018,54,Instant Family,120556201 ,67363237 ,55.90,53192964 ,44.10
154,2018,55,A Cool Fish,118153135 ,551876 ,0.50,117601259 ,99.50
155,2018,56,Game Night,117679066 ,69179066 ,58.80,48500000 ,41.20
156,2018,57,The Monkey King 3,115084576 ,187074 ,0.20,114897502 ,99.80
157,2018,58,Dragon Ball Super: Broly,114102821 ,30712119 ,26.90,83390702 ,73.10
158,2018,59,First Man,105697415 ,44936545 ,42.50,60760870 ,57.50
159,2018,60,Book Club,104438188 ,68566296 ,65.70,35871892 ,34.30
160,2018,61,Night School,103105878 ,77339130 ,75,25766748 ,25
161,2018,62,Alpha,98203196 ,35857181 ,36.50,62346015 ,63.50
162,2018,63,Along with the Gods: The Last 49 Days,97962238 ,1200246 ,1.20,96761992 ,98.80
163,2018,64,A Simple Favor,97644617 ,53548586 ,54.80,44096031 ,45.20
164,2018,65,The Favourite,95918706 ,34366783 ,35.80,61551923 ,64.20
165,2018,66,Truth or Dare,95330493 ,41411015 ,43.40,53919478 ,56.60
166,2018,67,I Feel Pretty,94539426 ,48795601 ,51.60,45743825 ,48.40
167,2018,68,Blockers,94017294 ,60311495 ,64.10,33705799 ,35.90
168,2018,69,BlacKkKlansman,93400823 ,49275340 ,52.80,44125483 ,47.20
169,2018,70,Goosebumps 2: Haunted Halloween,93320380 ,46700633 ,50,46619747 ,50
170,2018,71,Shadow,91708374 ,521396 ,0.60,91186978 ,99.40
171,2018,72,Overboard,91244913 ,50316123 ,55.10,40928790 ,44.90
172,2018,73,Sherlock Gnomes,90345871 ,43242871 ,47.90,47103000 ,52.10
173,2018,74,Detective Dee: The Four Heavenly Kings,90040771 ,262963 ,0.30,89777808 ,99.70
174,2018,75,I Can Only Imagine,85978248 ,83482352 ,97.10,2495896 ,2.90
175,2018,76,Robin Hood,85869850 ,30824628 ,35.90,55045222 ,64.10
176,2018,77,Mortal Engines,83672673 ,15951040 ,19.10,67721633 ,80.90
177,2018,78,How Long Will I Love U,82881319 ,746933 ,0.90,82134386 ,99.10
178,2018,79,Den of Thieves,80509622 ,44947622 ,55.80,35562000 ,44.20
179,2018,80,Hereditary,79336821 ,44069456 ,55.50,35267365 ,44.50
180,2018,81,Tag,78130625 ,54730625 ,70.10,23400000 ,29.90
181,2018,82,Vice,76073488 ,47836282 ,62.90,28237206 ,37.10
182,2018,83,Widows,75984700 ,42402632 ,55.80,33582068 ,44.20
183,2018,84,Sicario: Day of the Soldado,75836683 ,50072235 ,66,25764448 ,34
184,2018,85,Searching,75462037 ,26020957 ,34.50,49441080 ,65.50
185,2018,86,The Spy Who Dumped Me,75320680 ,33562069 ,44.60,41758611 ,55.40
186,2018,87,Second Act,72282227 ,39282227 ,54.30,33000000 ,45.70
187,2018,88,Sanju,71535130 ,7909317 ,11.10,63625813 ,88.90
188,2018,89,Spirited Away 2018 Re-release,70186029 ,1175067 ,1.70,69010962 ,98.30
189,2018,90,Shoplifters,67998910 ,3313513 ,4.90,64685397 ,95.10
190,2018,91,12 Strong,67450815 ,45819713 ,67.90,21631102 ,32.10
191,2018,92,"Love, Simon",66316289 ,40826341 ,61.60,25489948 ,38.40
192,2018,93,Mile 22,66308758 ,36108758 ,54.50,30200000 ,45.50
193,2018,94,Life of the Party,65859911 ,53059911 ,80.60,12800000 ,19.40
194,2018,95,Capernaum,64398132 ,1661096 ,2.60,62737036 ,97.40
195,2018,96,Isle of Dogs,64241499 ,32015231 ,49.80,32226268 ,50.20
196,2018,97,Adrift,59945012 ,31445012 ,52.50,28500000 ,47.50
197,2018,98,The 15:17 to Paris,57076286 ,36276286 ,63.60,20800000 ,36.40
198,2018,99,Early Man,54622814 ,8267544 ,15.10,46355270 ,84.90
199,2018,100,Peppermint,53918723 ,35418723 ,65.70,18500000 ,34.30
200,2017,1,Star Wars: Episode VIII - The Last Jedi,1332539889 ,620181382 ,46.50,712358507 ,53.50
201,2017,2,Beauty and the Beast,1263521126 ,504014165 ,39.90,759506961 ,60.10
202,2017,3,The Fate of the Furious,1236005118 ,226008385 ,18.30,1009996733 ,81.70
203,2017,4,Despicable Me 3,1034799409 ,264624300 ,25.60,770175109 ,74.40
204,2017,5,Jumanji: Welcome to the Jungle,962077546 ,404515480 ,42,557562066 ,58
205,2017,6,Spider-Man: Homecoming,880166924 ,334201140 ,38,545965784 ,62
206,2017,7,Wolf Warrior 2,870325439 ,2721100 ,0.30,867604339 ,99.70
207,2017,8,Guardians of the Galaxy Vol. 2,863756051 ,389813101 ,45.10,473942950 ,54.90
208,2017,9,Thor: Ragnarok,853977126 ,315058289 ,36.90,538918837 ,63.10
209,2017,10,Wonder Woman,821847012 ,412563408 ,50.20,409283604 ,49.80
210,2017,11,Coco,807082196 ,209726015 ,26,597356181 ,74
211,2017,12,Pirates of the Caribbean: Dead Men Tell No Tales,794861794 ,172558876 ,21.70,622302918 ,78.30
212,2017,13,It,700381748 ,327481748 ,46.80,372900000 ,53.20
213,2017,14,Justice League,657924295 ,229024295 ,34.80,428900000 ,65.20
214,2017,15,Logan,619021436 ,226277068 ,36.60,392744368 ,63.40
215,2017,16,Transformers: The Last Knight,605425157 ,130168683 ,21.50,475256474 ,78.50
216,2017,17,Kong: Skull Island,566652812 ,168052812 ,29.70,398600000 ,70.30
217,2017,18,The Boss Baby,527965936 ,175003033 ,33.10,352962903 ,66.90
218,2017,19,Dunkirk,525245546 ,188045546 ,35.80,337200000 ,64.20
219,2017,20,War for the Planet of the Apes,490719763 ,146880162 ,29.90,343839601 ,70.10
220,2017,21,The Greatest Showman,434993183 ,174340174 ,40.10,260653009 ,59.90
221,2017,22,Kingsman: The Golden Circle,410902662 ,100234838 ,24.40,310667824 ,75.60
222,2017,23,The Mummy,409231607 ,80227895 ,19.60,329003712 ,80.40
223,2017,24,Cars 3,383930656 ,152901115 ,39.80,231029541 ,60.20
224,2017,25,Fifty Shades Darker,381545846 ,114581250 ,30,266964596 ,70
225,2017,26,Murder on the Orient Express,352789811 ,102826543 ,29.10,249963268 ,70.90
226,2017,27,xXx: Return of Xander Cage,346118277 ,44898413 ,13,301219864 ,87
227,2017,28,The Lego Batman Movie,311950384 ,175750384 ,56.30,136200000 ,43.70
228,2017,29,The Ex-File 3: Return of the Exes,307592427 ,838959 ,0.30,306753468 ,99.70
229,2017,30,Annabelle: Creation,306515884 ,102092201 ,33.30,204423683 ,66.70
230,2017,31,Wonder,305937718 ,132422809 ,43.30,173514909 ,56.70
231,2017,32,Ferdinand,296069199 ,84410380 ,28.50,211658819 ,71.50
232,2017,33,Split,278454358 ,138291365 ,49.70,140162993 ,50.30
233,2017,34,Blade Runner 2049,259239658 ,92054159 ,35.50,167185499 ,64.50
234,2017,35,Get Out,255407969 ,176040665 ,68.90,79367304 ,31.10
235,2017,36,Kung Fu Yoga,254212245 ,362657 ,0.10,253849588 ,99.90
236,2017,37,Baahubali 2: The Conclusion,254158390 ,20186659 ,7.90,233971731 ,92.10
237,2017,38,Journey to the West: The Demons Strike Back,246620398 ,880346 ,0.40,245740052 ,99.60
238,2017,39,Alien: Covenant,240891763 ,74262031 ,30.80,166629732 ,69.20
239,2017,40,Paddington 2,227331938 ,40891591 ,18,186440347 ,82
240,2017,41,Youth,227091290 ,1891956 ,0.80,225199334 ,99.20
241,2017,42,Baby Driver,226945087 ,107825862 ,47.50,119119225 ,52.50
242,2017,43,Valerian and the City of a Thousand Planets,225874228 ,41189488 ,18.20,184684740 ,81.80
243,2017,44,Geostorm,221600160 ,33700160 ,15.20,187900000 ,84.80
244,2017,45,The Emoji Movie,217776646 ,86089513 ,39.50,131687133 ,60.50
245,2017,46,A Dog's Purpose,205035819 ,64508620 ,31.50,140527199 ,68.50
246,2017,47,Smurfs: The Lost Village,197183546 ,45020282 ,22.80,152163264 ,77.20
247,2017,48,The Shape of Water,195243464 ,63859435 ,32.70,131384029 ,67.30
248,2017,49,Pitch Perfect 3,185400345 ,104897530 ,56.60,80502815 ,43.40
249,2017,50,Daddy's Home 2,180613180 ,104029443 ,57.60,76583737 ,42.40
250,2017,51,The Post,179769457 ,81903458 ,45.60,97865999 ,54.40
251,2017,52,Baywatch,177856751 ,58060186 ,32.60,119796565 ,67.40
252,2017,53,The Hitman's Bodyguard,176586701 ,75468583 ,42.70,101118118 ,57.30
253,2017,54,John Wick: Chapter 2,171539887 ,92029184 ,53.60,79510703 ,46.40
254,2017,55,Ghost in the Shell,169801921 ,40563557 ,23.90,129238364 ,76.10
255,2017,56,"Three Billboards Outside Ebbing, Missouri",159210164 ,54513740 ,34.20,104696424 ,65.80
256,2017,57,Duckweed,151092784 ,471575 ,0.30,150621209 ,99.70
257,2017,58,Darkest Hour,150847207 ,56468410 ,37.40,94378797 ,62.60
258,2017,59,King Arthur: Legend of the Sword,148675066 ,39175066 ,26.30,109500000 ,73.70
259,2017,60,The Foreigner,145374099 ,34393507 ,23.70,110980592 ,76.30
260,2017,61,Power Rangers,142337240 ,85364450 ,60,56972790 ,40
261,2017,62,Girls Trip,140552359 ,115171585 ,81.90,25380774 ,18.10
262,2017,63,American Made,134866593 ,51342000 ,38.10,83524593 ,61.90
263,2017,64,A Bad Moms Christmas,130560428 ,72110659 ,55.20,58449769 ,44.80
264,2017,65,Happy Death Day,125479266 ,55683845 ,44.40,69795421 ,55.60
265,2017,66,Captain Underpants: The First Epic Movie,125427681 ,73921000 ,58.90,51506681 ,41.10
266,2017,67,The Lego Ninjago Movie,123081555 ,59281555 ,48.20,63800000 ,51.80
267,2017,68,Secret Superstar,121956937 ,,,121956937 ,100
268,2017,69,The Commuter,119942387 ,36343858 ,30.30,83598529 ,69.70
269,2017,70,The Dark Tower,113231078 ,50701325 ,44.80,62529753 ,55.20
270,2017,71,Buddies in India,109593721 ,293194 ,0.30,109300527 ,99.70
271,2017,72,Along with the Gods: The Two Worlds,109383972 ,1908823 ,1.70,107475149 ,98.30
272,2017,73,Jigsaw,102952888 ,38052832 ,37,64900056 ,63
273,2017,74,Life,100541806 ,30234022 ,30.10,70307784 ,69.90
274,2017,75,Atomic Blonde 2017 Re-release,100014025 ,51687870 ,51.70,48326155 ,48.30
275,2017,76,The Shack,96942115 ,57386418 ,59.20,39555697 ,40.80
276,2017,77,Chasing the Dragon,87965942 ,456854 ,0.50,87509088 ,99.50
277,2017,78,Tiger Zinda Hai,87320000 ,5560921 ,6.40,81759079 ,93.60
278,2017,79,Going in Style,84918541 ,45018541 ,53,39900000 ,47
279,2017,80,Rings,83080890 ,27793018 ,33.50,55287872 ,66.50
280,2017,81,Once Upon A Time,82886178 ,485728 ,0.60,82400450 ,99.40
281,2017,82,A Taxi Driver,81674009 ,1527829 ,1.90,80146180 ,98.10
282,2017,83,Lady Bird,78965611 ,48958273 ,62,30007338 ,38
283,2017,84,American Assassin,67234188 ,36249674 ,53.90,30984514 ,46.10
284,2017,85,Victoria & Abdul,65421267 ,22245070 ,34,43176197 ,66
285,2017,86,The Nut Job 2: Nutty by Nature,65146020 ,28370522 ,43.50,36775498 ,56.50
286,2017,87,The Mountain Between Us,62832209 ,30348555 ,48.30,32483654 ,51.70
287,2017,88,The Star,62812974 ,40852824 ,65,21960150 ,35
288,2017,89,47 Meters Down,62187529 ,44307191 ,71.20,17880338 ,28.80
289,2017,90,How to Be a Latin Lover,61881372 ,32149404 ,52,29731968 ,48
290,2017,91,"Everything, Everything",61621140 ,34121140 ,55.40,27500000 ,44.60
291,2017,92,Snatched,60845711 ,45852178 ,75.40,14993533 ,24.60
292,2017,93,My Little Pony: The Movie,60330833 ,21885107 ,36.30,38445726 ,63.70
293,2017,94,Molly's Game,59284015 ,28780744 ,48.50,30503271 ,51.50
294,2017,95,The Devotion of Suspect X,59035664 ,686435 ,1.20,58349229 ,98.80
295,2017,96,Shock Wave,58815633 ,,,58815633 ,100
296,2017,97,Goldbuster,57628292 ,186135 ,0.30,57442157 ,99.70
297,2017,98,All the Money in the World,56996304 ,25113707 ,44.10,31882597 ,55.90
298,2017,99,The Big Sick,56411585 ,42873127 ,76,13538458 ,24
299,2017,100,Confidential Assignment,55972241 ,475618 ,0.80,55496623 ,99.20
300,2016,1,Captain America: Civil War,1153296293 ,408084349 ,35.40,745211944 ,64.60
301,2016,2,Rogue One: A Star Wars Story,1056057273 ,532177324 ,50.40,523879949 ,49.60
302,2016,3,Finding Dory,1028570889 ,486295561 ,47.30,542275328 ,52.70
303,2016,4,Zootopia,1023784195 ,341268248 ,33.30,682515947 ,66.70
304,2016,5,The Jungle Book,966550600 ,364001123 ,37.70,602549477 ,62.30
305,2016,6,The Secret Life of Pets,875457937 ,368384330 ,42.10,507073607 ,57.90
306,2016,7,Fantastic Beasts and Where to Find Them,814037575 ,234037575 ,28.80,580000000 ,71.20
307,2016,8,Deadpool,782612155 ,363070709 ,46.40,419541446 ,53.60
308,2016,9,Suicide Squad,746846894 ,325100054 ,43.50,421746840 ,56.50
309,2016,10,Doctor Strange,677718395 ,232641920 ,34.30,445076475 ,65.70
310,2016,11,Moana,643331111 ,248757044 ,38.70,394574067 ,61.30
311,2016,12,Sing,634151679 ,270395425 ,42.60,363756254 ,57.40
312,2016,13,The Mermaid,553810228 ,3232685 ,0.60,550577543 ,99.40
313,2016,14,X-Men: Apocalypse,543934105 ,155442489 ,28.60,388491616 ,71.40
314,2016,15,Kung Fu Panda 3,521170825 ,143528619 ,27.50,377642206 ,72.50
315,2016,16,La La Land,446092357 ,151101803 ,33.90,294990554 ,66.10
316,2016,17,Warcraft: The Beginning,439048914 ,47365290 ,10.80,391683624 ,89.20
317,2016,18,Jason Bourne,415484914 ,162434410 ,39.10,253050504 ,60.90
318,2016,19,Ice Age: Collision Course,408579038 ,64063008 ,15.70,344516030 ,84.30
319,2016,20,Independence Day: Resurgence,389681935 ,103144286 ,26.50,286537649 ,73.50
320,2016,21,Your Name.,357986087 ,5017246 ,1.40,352968841 ,98.60
321,2016,22,The Legend of Tarzan,356700357 ,126643061 ,35.50,230057296 ,64.50
322,2016,23,The Angry Birds Movie,352333929 ,107509366 ,30.50,244824563 ,69.50
323,2016,24,Trolls,346864462 ,153707064 ,44.30,193157398 ,55.70
324,2016,25,Star Trek Beyond,343471816 ,158848340 ,46.20,184623476 ,53.80
325,2016,26,The Great Wall,334933831 ,45540830 ,13.60,289393001 ,86.40
326,2016,27,Now You See Me 2,334897606 ,65075540 ,19.40,269822066 ,80.60
327,2016,28,The Conjuring 2,320392818 ,102470008 ,32,217922810 ,68
328,2016,29,Resident Evil: The Final Chapter,312242626 ,26830068 ,8.60,285412558 ,91.40
329,2016,30,Passengers,303144152 ,100014699 ,33,203129453 ,67
330,2016,31,Dangal,302895451 ,12391761 ,4.10,290503690 ,95.90
331,2016,32,Alice Through the Looking Glass,299457024 ,77041381 ,25.70,222415643 ,74.30
332,2016,33,Miss Peregrine's Home for Peculiar Children,296482446 ,87242834 ,29.40,209239612 ,70.60
333,2016,34,Teenage Mutant Ninja Turtles: Out of the Shadows,245623848 ,82051601 ,33.40,163572247 ,66.60
334,2016,35,Sully,240797623 ,125070033 ,51.90,115727590 ,48.10
335,2016,36,Assassin's Creed,240697856 ,54647948 ,22.70,186049908 ,77.30
336,2016,37,Hidden Figures,235956898 ,169607287 ,71.90,66349611 ,28.10
337,2016,38,Ghostbusters,229147509 ,128350574 ,56,100796935 ,44
338,2016,39,Inferno,220021259 ,34343574 ,15.60,185677685 ,84.40
339,2016,40,Central Intelligence,216972543 ,127440871 ,58.70,89531672 ,41.30
340,2016,41,Bridget Jones's Baby,211952420 ,24252420 ,11.40,187700000 ,88.60
341,2016,42,Me Before You,208314186 ,56245075 ,27,152069111 ,73
342,2016,43,London Has Fallen,205754447 ,62524260 ,30.40,143230187 ,69.60
343,2016,44,Arrival,203388186 ,100546139 ,49.40,102842047 ,50.60
344,2016,45,The Monkey King 2,193677158 ,709982 ,0.40,192967176 ,99.60
345,2016,46,Bad Moms,183936074 ,113257297 ,61.60,70678777 ,38.40
346,2016,47,Storks,183388953 ,72679278 ,39.60,110709675 ,60.40
347,2016,48,The BFG,183288689 ,55483770 ,30.30,127804919 ,69.70
348,2016,49,Allegiant,179246868 ,66184051 ,36.90,113062817 ,63.10
349,2016,50,Hacksaw Ridge,175302354 ,67209615 ,38.30,108092739 ,61.70
350,2016,51,The Girl on the Train,173185859 ,75395035 ,43.50,97790824 ,56.50
351,2016,52,Operation Mekong,173128787 ,800012 ,0.50,172328775 ,99.50
352,2016,53,The Huntsman: Winter's War,164989338 ,48390190 ,29.30,116599148 ,70.70
353,2016,54,The Magnificent Seven,162360636 ,93432655 ,57.50,68927981 ,42.50
354,2016,55,Jack Reacher: Never Go Back,162146076 ,58697076 ,36.20,103449000 ,63.80
355,2016,56,Don't Breathe,157100845 ,89217875 ,56.80,67882970 ,43.20
356,2016,57,The Accountant,155160045 ,86260045 ,55.60,68900000 ,44.40
357,2016,58,Lights Out,148868835 ,67268835 ,45.20,81600000 ,54.80
358,2016,59,Pete's Dragon,143695338 ,76233151 ,53.10,67462187 ,46.90
359,2016,60,Sausage Party,140705322 ,97685686 ,69.40,43019636 ,30.60
360,2016,61,Lion,140312928 ,51738905 ,36.90,88574023 ,63.10
361,2016,62,Mechanic: Resurrection,125729635 ,21218403 ,16.90,104511232 ,83.10
362,2016,63,Deepwater Horizon,121790373 ,61433527 ,50.40,60356846 ,49.60
363,2016,64,Allied,119520023 ,40098064 ,33.50,79421959 ,66.50
364,2016,65,I Belonged to You,119107580 ,744541 ,0.60,118363039 ,99.40
365,2016,66,The Shallows,119100758 ,55124043 ,46.30,63976715 ,53.70
366,2016,67,The Purge: Election Year,118587880 ,79213375 ,66.80,39374505 ,33.20
367,2016,68,Why Him?,118102725 ,60323786 ,51.10,57778939 ,48.90
368,2016,69,Finding Mr Right 2,114679097 ,,,114679097 ,100
369,2016,70,Office Christmas Party,114501299 ,54767494 ,47.80,59733805 ,52.20
370,2016,71,How to Be Single,112343513 ,46843513 ,41.70,65500000 ,58.30
371,2016,72,10 Cloverfield Lane,110216998 ,72082998 ,65.40,38134000 ,34.60
372,2016,73,Neighbors 2: Sorority Rising,108007109 ,55455765 ,51.30,52551344 ,48.70
373,2016,74,Cold War II,103197501 ,560824 ,0.50,102636677 ,99.50
374,2016,75,Railroad Tigers,102205175 ,218044 ,0.20,101987131 ,99.80
375,2016,76,Some Like It Hot,95721320 ,100026 ,0.10,95621294 ,99.90
376,2016,77,Dirty Grandpa,94073028 ,35593113 ,37.80,58479915 ,62.20
377,2016,78,Ben-Hur,94061311 ,26410477 ,28.10,67650834 ,71.90
378,2016,79,Money Monster,93282604 ,41012075 ,44,52270529 ,56
379,2016,80,My Big Fat Greek Wedding 2,88923251 ,59689605 ,67.10,29233646 ,32.90
380,2016,81,Collateral Beauty,88528280 ,31016021 ,35,57512259 ,65
381,2016,82,Train to Busan,87547518 ,2129768 ,2.40,85417750 ,97.60
382,2016,83,Sultan,87280000 ,6200000 ,7.10,81080000 ,92.90
383,2016,84,War Dogs,86234523 ,43034523 ,49.90,43200000 ,50.10
384,2016,85,Nerve,85251425 ,38583626 ,45.30,46667799 ,54.70
385,2016,86,Leap!,84197417 ,2844490 ,3.40,81352927 ,96.60
386,2016,87,Ouija: Origin of Evil,81705746 ,35144505 ,43,46561241 ,57
387,2016,88,Underworld: Blood Wars,81093313 ,30353973 ,37.40,50739340 ,62.60
388,2016,89,Manchester by the Sea,78988148 ,47695371 ,60.40,31292777 ,39.60
389,2016,90,The Boss,78844582 ,63285885 ,80.30,15558697 ,19.70
390,2016,91,Shin Godzilla,77947607 ,1918403 ,2.50,76029204 ,97.50
391,2016,92,Mike and Dave Need Wedding Dates,77068246 ,46009673 ,59.70,31058573 ,40.30
392,2016,93,Boo! A Madea Halloween,74827344 ,73206343 ,97.80,1621001 ,2.20
393,2016,94,Miracles from Heaven,73883359 ,61705123 ,83.50,12178236 ,16.50
394,2016,95,I Am Not Madame Bovary,70826207 ,436798 ,0.60,70389409 ,99.40
395,2016,96,Kubo and the Two Strings,69929545 ,48023088 ,68.70,21906457 ,31.30
396,2016,97,One Piece Film: Gold,66207073 ,423593 ,0.60,65783480 ,99.40
397,2016,98,Moonlight,65046687 ,27854932 ,42.80,37191755 ,57.20
398,2016,99,Monster Trucks,64493915 ,33370166 ,51.70,31123749 ,48.30
399,2016,100,Fences,64414761 ,57682904 ,89.50,6731857 ,10.50
400,2015,1,Star Wars: Episode VII - The Force Awakens,2068223624 ,936662225 ,45.30,1131561399 ,54.70
401,2015,2,Jurassic World,1670400637 ,652270625 ,39,1018130012 ,61
402,2015,3,Furious 7,1515047671 ,353007020 ,23.30,1162040651 ,76.70
403,2015,4,Avengers: Age of Ultron,1402805868 ,459005868 ,32.70,943800000 ,67.30
404,2015,5,Minions,1159398397 ,336045770 ,29,823352627 ,71
405,2015,6,Spectre,880674609 ,200074609 ,22.70,680600000 ,77.30
406,2015,7,Batman v Superman: Dawn of Justice,873634919 ,330360194 ,37.80,543274725 ,62.20
407,2015,8,Inside Out,857611174 ,356461711 ,41.60,501149463 ,58.40
408,2015,9,Mission: Impossible - Rogue Nation,682714267 ,195042377 ,28.60,487671890 ,71.40
409,2015,10,The Hunger Games: Mockingjay - Part 2,653428261 ,281723902 ,43.10,371704359 ,56.90
410,2015,11,The Martian,630161890 ,228433663 ,36.20,401728227 ,63.80
411,2015,12,Fifty Shades of Grey,569651467 ,166167230 ,29.20,403484237 ,70.80
412,2015,13,Cinderella,542351353 ,201151353 ,37.10,341200000 ,62.90
413,2015,14,The Revenant,532950503 ,183637894 ,34.50,349312609 ,65.50
414,2015,15,Ant-Man,519311965 ,180202163 ,34.70,339109802 ,65.30
415,2015,16,Hotel Transylvania 2,474800000 ,169700110 ,35.70,305099890 ,64.30
416,2015,17,San Andreas,473990832 ,155190832 ,32.70,318800000 ,67.30
417,2015,18,Terminator Genisys,440603537 ,89760956 ,20.40,350842581 ,79.60
418,2015,19,Kingsman: The Secret Service,414351546 ,128261724 ,31,286089822 ,69
419,2015,20,Home,386041607 ,177397510 ,46,208644097 ,54
420,2015,21,Monster Hunt,385284817 ,32766 ,<0.1,385252051 ,100
421,2015,22,Mad Max: Fury Road,374736354 ,153636354 ,41,221100000 ,59
422,2015,23,The Good Dinosaur,332207671 ,123087120 ,37.10,209120551 ,62.90
423,2015,24,Taken 3,326479141 ,89256424 ,27.30,237222717 ,72.70
424,2015,25,The SpongeBob Movie: Sponge Out of Water,325186032 ,162994032 ,50.10,162192000 ,49.90
425,2015,26,Maze Runner: The Scorch Trials,312296056 ,81697192 ,26.20,230598864 ,73.80
426,2015,27,Insurgent,297002527 ,130179072 ,43.80,166823455 ,56.20
427,2015,28,Pitch Perfect 2,287144079 ,184296230 ,64.20,102847849 ,35.80
428,2015,29,Mojin - The Lost Legend,259368448 ,1243810 ,0.50,258124638 ,99.50
429,2015,30,Lost in Hong Kong,256283912 ,1302281 ,0.50,254981631 ,99.50
430,2015,31,The Peanuts Movie,246233113 ,130178411 ,52.90,116054702 ,47.10
431,2015,32,Pixels,244874809 ,78747585 ,32.20,166127224 ,67.80
432,2015,33,Daddy's Home,242786137 ,150357137 ,61.90,92429000 ,38.10
433,2015,34,Spy,235666219 ,110825712 ,47,124840507 ,53
434,2015,35,Alvin and the Chipmunks: The Road Chip,234798636 ,85886987 ,36.60,148911649 ,63.40
435,2015,36,Goodbye Mr. Loser,228122928 ,1293626 ,0.60,226829302 ,99.40
436,2015,37,Ted 2,215863606 ,81476385 ,37.70,134387221 ,62.30
437,2015,38,Tomorrowland,209035668 ,93436322 ,44.70,115599346 ,55.30
438,2015,39,Everest,203427584 ,43482270 ,21.40,159945314 ,78.60
439,2015,40,Straight Outta Compton,201634991 ,161197785 ,79.90,40437206 ,20.10
440,2015,41,The Intern,194564672 ,75764672 ,38.90,118800000 ,61.10
441,2015,42,Jupiter Ascending,183887723 ,47387723 ,25.80,136500000 ,74.20
442,2015,43,Creed,173567581 ,109767581 ,63.20,63800000 ,36.80
443,2015,44,Fantastic Four,167882881 ,56117548 ,33.40,111765333 ,66.60
444,2015,45,Bridge of Spies,165478348 ,72313754 ,43.70,93164594 ,56.30
445,2015,46,Focus,158762963 ,53862963 ,33.90,104900000 ,66.10
446,2015,47,Goosebumps,158260952 ,80080379 ,50.60,78180573 ,49.40
447,2015,48,Ip Man 3,156844753 ,2679437 ,1.70,154165316 ,98.30
448,2015,49,The Hateful Eight,155760117 ,54117416 ,34.70,101642701 ,65.30
449,2015,50,Gods of Egypt,150680864 ,31153464 ,20.70,119527400 ,79.30
450,2015,51,The Last Witch Hunter,146936910 ,27367660 ,18.60,119569250 ,81.40
451,2015,52,Trainwreck,140795793 ,110212700 ,78.30,30583093 ,21.70
452,2015,53,Mr. Six,139191345 ,1415450 ,1,137775895 ,99
453,2015,54,Point Break,133718711 ,28782481 ,21.50,104936230 ,78.50
454,2015,55,The Big Short,133440870 ,70259870 ,52.70,63181000 ,47.30
455,2015,56,Pan,128388320 ,35088320 ,27.30,93300000 ,72.70
456,2015,57,Detective Chinatown,125842935 ,474252 ,0.40,125368683 ,99.60
457,2015,58,Wolf Totem,125799039 ,210591 ,0.20,125588448 ,99.80
458,2015,59,Ride Along 2,124605297 ,91221830 ,73.20,33383467 ,26.80
459,2015,60,Dragon Blade,121545703 ,74068 ,<0.1,121471635 ,99.90
460,2015,61,Magic Mike XXL,117813057 ,66013057 ,56,51800000 ,44
461,2015,62,Insidious: Chapter 3,112983889 ,52218558 ,46.20,60765331 ,53.80
462,2015,63,Get Hard,111711453 ,90411453 ,80.90,21300000 ,19.10
463,2015,64,The 5th Wave,109906372 ,34916787 ,31.80,74989585 ,68.20
464,2015,65,Paul Blart: Mall Cop 2,107588225 ,71038190 ,66,36550035 ,34
465,2015,66,The Man from U.N.C.L.E.,107045109 ,45445109 ,42.50,61600000 ,57.50
466,2015,67,Shaun the Sheep Movie,106209378 ,19375982 ,18.20,86833396 ,81.80
467,2015,68,Sisters,105011053 ,87044645 ,82.90,17966408 ,17.10
468,2015,69,Vacation,104884188 ,58884188 ,56.10,46000000 ,43.90
469,2015,70,Chappie,102069268 ,31569268 ,30.90,70500000 ,69.10
470,2015,71,Joy,101134059 ,56451232 ,55.80,44682827 ,44.20
471,2015,72,Black Mass,99775678 ,62575678 ,62.70,37200000 ,37.30
472,2015,73,Devil and Angel,98599942 ,131058 ,0.10,98468884 ,99.90
473,2015,74,The Visit,98450062 ,65206105 ,66.20,33243957 ,33.80
474,2015,75,Spotlight,98275238 ,45055776 ,45.80,53219462 ,54.20
475,2015,76,The Little Prince,97571250 ,1339152 ,1.40,96232098 ,98.60
476,2015,77,Assassination,96119773 ,1904682 ,2,94215091 ,98
477,2015,78,Poltergeist,95437994 ,47425125 ,49.70,48012869 ,50.30
478,2015,79,Veteran,94393020 ,1200627 ,1.30,93192393 ,98.70
479,2015,80,In the Heart of the Sea,93920758 ,25020758 ,26.60,68900000 ,73.40
480,2015,81,Kill Zone 2,93638358 ,11998 ,<0.1,93626360 ,100
481,2015,82,Southpaw,91970827 ,52421953 ,57,39548874 ,43
482,2015,83,The Second Best Exotic Marigold Hotel,85978266 ,33078266 ,38.50,52900000 ,61.50
483,2015,84,Paper Towns,85512300 ,32000304 ,37.40,53511996 ,62.60
484,2015,85,Sicario,84872444 ,46889293 ,55.20,37983151 ,44.80
485,2015,86,Hitman: Agent 47,82347656 ,22467450 ,27.30,59880206 ,72.70
486,2015,87,The Wedding Ringer,79799880 ,64460211 ,80.80,15339669 ,19.20
487,2015,88,Paranormal Activity: The Ghost Dimension,78903124 ,18300124 ,23.20,60603000 ,76.80
488,2015,89,Bajrangi Bhaijaan,75547184 ,8178001 ,10.80,67369183 ,89.20
489,2015,90,War Room,73256266 ,67790117 ,92.50,5466149 ,7.50
490,2015,91,The Transporter Refueled,72629670 ,16029670 ,22.10,56600000 ,77.90
491,2015,92,Run All Night,71561644 ,26461644 ,37,45100000 ,63
492,2015,93,13 Hours,69411370 ,52853219 ,76.10,16558151 ,23.90
493,2015,94,Running Man,68782475 ,310978 ,0.50,68471497 ,99.50
494,2015,95,The Age of Adaline,65663276 ,42629776 ,64.90,23033500 ,35.10
495,2015,96,Zhongkui: Snow Girl and the Dark Crystal,64325947 ,165428 ,0.30,64160519 ,99.70
496,2015,97,The Danish Girl,64191523 ,11114018 ,17.30,53077505 ,82.70
497,2015,98,The Boy,64188367 ,35819556 ,55.80,28368811 ,44.20
498,2015,99,The Longest Ride,62944815 ,37446117 ,59.50,25498698 ,40.50
499,2015,100,Unfriended,62882090 ,32482090 ,51.70,30400000 ,48.30
500,2014,1,Transformers: Age of Extinction,1104054072 ,245439076 ,22.20,858614996 ,77.80
501,2014,2,The Hobbit: The Battle of the Five Armies,956019788 ,255119788 ,26.70,700900000 ,73.30
502,2014,3,Guardians of the Galaxy,772776600 ,333176600 ,43.10,439600000 ,56.90
503,2014,4,Maleficent,758410378 ,241410378 ,31.80,517000000 ,68.20
504,2014,5,The Hunger Games: Mockingjay - Part 1,755356711 ,337135885 ,44.60,418220826 ,55.40
505,2014,6,X-Men: Days of Future Past,746045700 ,233921534 ,31.40,512124166 ,68.60
506,2014,7,Captain America: The Winter Soldier,714421503 ,259766572 ,36.40,454654931 ,63.60
507,2014,8,Dawn of the Planet of the Apes,710644566 ,208545589 ,29.30,502098977 ,70.70
508,2014,9,The Amazing Spider-Man 2,708982323 ,202853933 ,28.60,506128390 ,71.40
509,2014,10,Interstellar,677463813 ,188020017 ,27.80,489443796 ,72.20
510,2014,11,Big Hero 6,657827828 ,222527828 ,33.80,435300000 ,66.20
511,2014,12,How to Train Your Dragon 2,621537519 ,177002924 ,28.50,444534595 ,71.50
512,2014,13,American Sniper,547426372 ,350126372 ,64,197300000 ,36
513,2014,14,Godzilla,524976069 ,200676069 ,38.20,324300000 ,61.80
514,2014,15,Rio 2,498781117 ,131538435 ,26.40,367242682 ,73.60
515,2014,16,Teenage Mutant Ninja Turtles,485004754 ,191204754 ,39.40,293800000 ,60.60
516,2014,17,The Lego Movie,468060692 ,257760692 ,55.10,210300000 ,44.90
517,2014,18,Lucy,458863600 ,126663600 ,27.60,332200000 ,72.40
518,2014,19,Penguins of Madagascar,373515621 ,83850911 ,22.40,289664710 ,77.60
519,2014,20,Edge of Tomorrow,370541256 ,100206256 ,27,270335000 ,73
520,2014,21,Gone Girl,369330363 ,167767189 ,45.40,201563174 ,54.60
521,2014,22,Night at the Museum: Secret of the Tomb,363204635 ,113746621 ,31.30,249458014 ,68.70
522,2014,23,Noah,359200044 ,101200044 ,28.20,258000000 ,71.80
523,2014,24,The Maze Runner,348319861 ,102427862 ,29.40,245891999 ,70.60
524,2014,25,300: Rise of an Empire,337580051 ,106580051 ,31.60,231000000 ,68.40
525,2014,26,22 Jump Street,331333876 ,191719337 ,57.90,139614539 ,42.10
526,2014,27,The Fault in Our Stars,307166834 ,124872350 ,40.70,182294484 ,59.30
527,2014,28,Divergent,288885818 ,150947895 ,52.30,137937923 ,47.70
528,2014,29,Mr. Peabody & Sherman,275698039 ,111506430 ,40.40,164191609 ,59.60
529,2014,30,Neighbors,270665134 ,150157400 ,55.50,120507734 ,44.50
530,2014,31,Exodus: Gods and Kings,268175631 ,65014513 ,24.20,203161118 ,75.80
531,2014,32,Paddington,268047808 ,76271832 ,28.50,191775976 ,71.50
532,2014,33,Annabelle,257047661 ,84273813 ,32.80,172773848 ,67.20
533,2014,34,Hercules,244819862 ,72688614 ,29.70,172131248 ,70.30
534,2014,35,RoboCop,242688965 ,58607007 ,24.10,184081958 ,75.90
535,2014,36,The Imitation Game,233555708 ,91125683 ,39,142430025 ,61
536,2014,37,Non-Stop,222809600 ,92168600 ,41.40,130641000 ,58.60
537,2014,38,Dracula Untold,217124280 ,56280355 ,25.90,160843925 ,74.10
538,2014,39,The Expendables 3,214657577 ,39322544 ,18.30,175335033 ,81.70
539,2014,40,Into the Woods,212902372 ,128002372 ,60.10,84900000 ,39.90
540,2014,41,Fury,211817906 ,85817906 ,40.50,126000000 ,59.50
541,2014,42,Need for Speed,203277636 ,43577636 ,21.40,159700000 ,78.60
542,2014,43,The Other Woman,196710396 ,83911193 ,42.70,112799203 ,57.30
543,2014,44,The Equalizer,192330738 ,101530738 ,52.80,90800000 ,47.20
544,2014,45,Breakup Buddies,189017596 ,777896 ,0.40,188239700 ,99.60
545,2014,46,The Grand Budapest Hotel,172936941 ,59301324 ,34.30,113635617 ,65.70
546,2014,47,Dumb and Dumber To,169837010 ,86208010 ,50.80,83629000 ,49.20
547,2014,48,Into the Storm,161502194 ,47602194 ,29.50,113900000 ,70.50
548,2014,49,Unbroken,161459297 ,115637895 ,71.60,45821402 ,28.40
549,2014,50,The Monuments Men,154984035 ,78031620 ,50.30,76952415 ,49.70
550,2014,51,Ride Along,154468902 ,134938200 ,87.40,19530702 ,12.60
551,2014,52,Planes: Fire & Rescue,146965787 ,59165787 ,40.30,87800000 ,59.70
552,2014,53,The Taking of Tiger Mountain,141654055 ,228984 ,0.20,141425071 ,99.80
553,2014,54,Let's Be Cops,138224951 ,82390774 ,59.60,55834177 ,40.40
554,2014,55,Jack Ryan: Shadow Recruit,135503748 ,50577412 ,37.30,84926336 ,62.70
555,2014,56,Annie,133821816 ,85911262 ,64.20,47910554 ,35.80
556,2014,57,Blended,127994610 ,46294610 ,36.20,81700000 ,63.80
557,2014,58,Sex Tape,126069509 ,38543473 ,30.60,87526036 ,69.40
558,2014,59,The Theory of Everything,123726688 ,35893537 ,29,87833151 ,71
559,2014,60,The Nut Job,120885527 ,64251541 ,53.20,56633986 ,46.80
560,2014,61,Pompeii,117831631 ,23219748 ,19.70,94611883 ,80.30
561,2014,62,Seventh Son,114178613 ,17223265 ,15.10,96955348 ,84.90
562,2014,63,The Admiral,112156811 ,2589811 ,2.30,109567000 ,97.70
563,2014,64,The Purge: Anarchy,111928365 ,71962800 ,64.30,39965565 ,35.70
564,2014,65,The Boxtrolls,108255770 ,50837305 ,47,57418465 ,53
565,2014,66,Horrible Bosses 2,107645357 ,54445357 ,50.60,53200000 ,49.40
566,2014,67,The Breakup Guru,106980263 ,208959 ,0.20,106771304 ,99.80
567,2014,68,Ouija,103590271 ,50856010 ,49.10,52734261 ,50.90
568,2014,69,Birdman or (The Unexpected Virtue of Ignorance),103215094 ,42340598 ,41,60874496 ,59
569,2014,70,Transcendence,103039258 ,23022309 ,22.30,80016949 ,77.70
570,2014,71,Heaven Is for Real,101332962 ,91443253 ,90.20,9889709 ,9.80
571,2014,72,"Alexander and the Terrible, Horrible, No Good, Very Bad Day",100654149 ,66954149 ,66.50,33700000 ,33.50
572,2014,73,Tammy,100375432 ,84525432 ,84.20,15850000 ,15.80
573,2014,74,PK,100370104 ,10616104 ,10.60,89754000 ,89.40
574,2014,75,The Book of Life,99783556 ,50151543 ,50.30,49632013 ,49.70
575,2014,76,Ode to My Father,99085291 ,2300121 ,2.30,96785170 ,97.70
576,2014,77,Cong cong na nian,94244191 ,569280 ,0.60,93674911 ,99.40
577,2014,78,Paranormal Activity: The Marked Ones,90894962 ,32462372 ,35.70,58432590 ,64.30
578,2014,79,The Hundred-Foot Journey,88880821 ,54240821 ,61,34640000 ,39
579,2014,80,Deliver Us from Evil,87937815 ,30577122 ,34.80,57360693 ,65.20
580,2014,81,A Million Ways to Die in the West,87189756 ,43139300 ,49.50,44050456 ,50.50
581,2014,82,Step Up All In,86165646 ,14904384 ,17.30,71261262 ,82.70
582,2014,83,John Wick,86013056 ,43037835 ,50,42975221 ,50
583,2014,84,The Judge,84419388 ,47119388 ,55.80,37300000 ,44.20
584,2014,85,Muppets Most Wanted,80383113 ,51183113 ,63.70,29200000 ,36.30
585,2014,86,If I Stay,78274843 ,50474843 ,64.50,27800000 ,35.50
586,2014,87,Crimson Peak,74679822 ,31090320 ,41.60,43589502 ,58.40
587,2014,88,"I, Frankenstein",71154592 ,19075290 ,26.80,52079302 ,73.20
588,2014,89,Think Like a Man Too,70181428 ,65182182 ,92.90,4999246 ,7.10
589,2014,90,Brick Mansions,68896829 ,20396829 ,29.60,48500000 ,70.40
590,2014,91,Son of God,67800064 ,59700064 ,88.10,8100000 ,11.90
591,2014,92,Jersey Boys,67647013 ,47047013 ,69.50,20600000 ,30.50
592,2014,93,The Giver,66980456 ,45090374 ,67.30,21890082 ,32.70
593,2014,94,Selma,66787908 ,52076908 ,78,14711000 ,22
594,2014,95,Beijing Love Story,65842375 ,428318 ,0.70,65414057 ,99.30
595,2014,96,God's Not Dead,64667874 ,60755732 ,94,3912142 ,6
596,2014,97,Begin Again,63464861 ,16170632 ,25.50,47294229 ,74.50
597,2014,98,The Walk,61181942 ,10137502 ,16.60,51044440 ,83.40
598,2014,99,Dolphin Tale 2,57824533 ,42024533 ,72.70,15800000 ,27.30
599,2014,100,St. Vincent,54837234 ,44137712 ,80.50,10699522 ,19.50
600,2013,1,Frozen,1274219009 ,400738009 ,31.40,873481000 ,68.60
601,2013,2,Iron Man 3,1214811252 ,409013994 ,33.70,805797258 ,66.30
602,2013,3,Despicable Me 2,970766005 ,368065385 ,37.90,602700620 ,62.10
603,2013,4,The Hobbit: The Desolation of Smaug,958366855 ,258366855 ,27,700000000 ,73
604,2013,5,The Hunger Games: Catching Fire,865011746 ,424668047 ,49.10,440343699 ,50.90
605,2013,6,Fast & Furious 6,788679850 ,238679850 ,30.30,550000000 ,69.70
606,2013,7,Monsters University,743559607 ,268492764 ,36.10,475066843 ,63.90
607,2013,8,Gravity,723192705 ,274092705 ,37.90,449100000 ,62.10
608,2013,9,Man of Steel,668045518 ,291045518 ,43.60,377000000 ,56.40
609,2013,10,Thor: The Dark World,644783140 ,206362140 ,32,438421000 ,68
610,2013,11,The Croods,587204668 ,187168425 ,31.90,400036243 ,68.10
611,2013,12,World War Z,540007876 ,202359711 ,37.50,337648165 ,62.50
612,2013,13,Oz the Great and Powerful,493311825 ,234911825 ,47.60,258400000 ,52.40
613,2013,14,Star Trek Into Darkness,467365246 ,228778661 ,49,238586585 ,51
614,2013,15,The Wolverine,414828246 ,132556852 ,32,282271394 ,68
615,2013,16,Pacific Rim,411002906 ,101802906 ,24.80,309200000 ,75.20
616,2013,17,The Wolf of Wall Street,392000694 ,116900694 ,29.80,275100000 ,70.20
617,2013,18,G.I. Joe: Retaliation,375740705 ,122523060 ,32.60,253217645 ,67.40
618,2013,19,The Hangover Part III,362000072 ,112200072 ,31,249800000 ,69
619,2013,20,The Great Gatsby,353641895 ,144840419 ,41,208801476 ,59
620,2013,21,Now You See Me,351723989 ,117723989 ,33.50,234000000 ,66.50
621,2013,22,The Smurfs 2,347545360 ,71017784 ,20.40,276527576 ,79.60
622,2013,23,The Conjuring,319494638 ,137400141 ,43,182094497 ,57
623,2013,24,A Good Day to Die Hard,304654182 ,67349198 ,22.10,237304984 ,77.90
624,2013,25,Oblivion,286168572 ,89107235 ,31.10,197061337 ,68.90
625,2013,26,Elysium,286140700 ,93050117 ,32.50,193090583 ,67.50
626,2013,27,Turbo,282570682 ,83028128 ,29.40,199542554 ,70.60
627,2013,28,Cloudy with a Chance of Meatballs 2,274325949 ,119793567 ,43.70,154532382 ,56.30
628,2013,29,Epic,268426634 ,107518682 ,40.10,160907952 ,59.90
629,2013,30,The Lone Ranger,260502115 ,89302115 ,34.30,171200000 ,65.70
630,2013,31,American Hustle,251171807 ,150117807 ,59.80,101054000 ,40.20
631,2013,32,Grown Ups 2,246984278 ,133668525 ,54.10,113315753 ,45.90
632,2013,33,After Earth,243611982 ,60522097 ,24.80,183089885 ,75.20
633,2013,34,Planes,239258712 ,90288712 ,37.70,148970000 ,62.30
634,2013,35,The Heat,229930771 ,159582188 ,69.40,70348583 ,30.60
635,2013,36,Hansel & Gretel: Witch Hunters,226349749 ,55703475 ,24.60,170646274 ,75.40
636,2013,37,Captain Phillips,218791811 ,107100855 ,49,111690956 ,51
637,2013,38,Journey to the West,205637183 ,18058 ,<0.1,205619125 ,100
638,2013,39,White House Down,205366737 ,73103784 ,35.60,132262953 ,64.40
639,2013,40,Percy Jackson: Sea of Monsters,199850315 ,68559554 ,34.30,131290761 ,65.70
640,2013,41,Jack the Giant Slayer,197687603 ,65187603 ,33,132500000 ,67
641,2013,42,The Secret Life of Walter Mitty,188133322 ,58236838 ,31,129896484 ,69
642,2013,43,12 Years a Slave,187733202 ,56671993 ,30.20,131061209 ,69.80
643,2013,44,Lee Daniels' The Butler,176598908 ,116632095 ,66,59966813 ,34
644,2013,45,Identity Thief,173965010 ,134506920 ,77.30,39458090 ,22.70
645,2013,46,Anchorman 2: The Legend Continues,171464676 ,125168368 ,73,46296308 ,27
646,2013,47,Olympus Has Fallen,170270201 ,98925640 ,58.10,71344561 ,41.90
647,2013,48,Insidious: Chapter 2,161919318 ,83586447 ,51.60,78332871 ,48.40
648,2013,49,Lone Survivor,154802912 ,125095601 ,80.80,29707311 ,19.20
649,2013,50,Bad Grandpa,151826547 ,102003019 ,67.20,49823528 ,32.80
650,2013,51,47 Ronin,151783839 ,38362475 ,25.30,113421364 ,74.70
651,2013,52,RED 2,148075565 ,53262560 ,36,94813005 ,64
652,2013,53,Mama,146428180 ,71628180 ,48.90,74800000 ,51.10
653,2013,54,Escape Plan,137328301 ,25135965 ,18.30,112192336 ,81.70
654,2013,55,The Wind Rises 2013 Re-release,136360863 ,5209580 ,3.80,131151283 ,96.20
655,2013,56,2 Guns,131940411 ,75612460 ,57.30,56327951 ,42.70
656,2013,57,This Is the End,126041322 ,101470202 ,80.50,24571120 ,19.50
657,2013,58,Ender's Game,125537191 ,61737191 ,49.20,63800000 ,50.80
658,2013,59,Prisoners,122126687 ,61002302 ,50,61124385 ,50
659,2013,60,Saving Mr. Banks,117867984 ,83301580 ,70.70,34566404 ,29.30
660,2013,61,Warm Bodies,116980662 ,66380662 ,56.70,50600000 ,43.30
661,2013,62,Jurassic Park 2013 Re-release,116485935 ,45385935 ,39,71100000 ,61
662,2013,63,Personal Tailor,116126458 ,375892 ,0.30,115750566 ,99.70
663,2013,64,So Young,114926694 ,11186 ,<0.1,114915508 ,100
664,2013,65,Free Birds,110387072 ,55750480 ,50.50,54636592 ,49.50
665,2013,66,Gangster Squad,105200903 ,46000903 ,43.70,59200000 ,56.30
666,2013,67,Philomena,100129872 ,37709979 ,37.70,62419893 ,62.30
667,2013,68,Instructions Not Included,99067206 ,44467206 ,44.90,54600000 ,55.10
668,2013,69,Riddick,98337295 ,42025135 ,42.70,56312160 ,57.30
669,2013,70,Safe Haven,97594140 ,71349120 ,73.10,26245020 ,26.90
670,2013,71,Evil Dead,97542952 ,54239856 ,55.60,43303096 ,44.40
671,2013,72,Blue Jasmine,97505481 ,33405481 ,34.30,64100000 ,65.70
672,2013,73,42,97470701 ,95020213 ,97.50,2450488 ,2.50
673,2013,74,The Mortal Instruments: City of Bones,95396573 ,31165421 ,32.70,64231152 ,67.30
674,2013,75,Police Story: Lockdown,94249025 ,,,94249025 ,100
675,2013,76,The Internship,93492844 ,44672764 ,47.80,48820080 ,52.20
676,2013,77,Rush,90247624 ,26947624 ,29.90,63300000 ,70.10
677,2013,78,The Purge,89328627 ,64473115 ,72.20,24855512 ,27.80
678,2013,79,Dhoom 3,88031955 ,8031955 ,9.10,80000000 ,90.90
679,2013,80,About Time,87100449 ,15322921 ,17.60,71777528 ,82.40
680,2013,81,Snowpiercer,86758912 ,4563650 ,5.30,82195262 ,94.70
681,2013,82,Pain & Gain,86175291 ,49875291 ,57.90,36300000 ,42.10
682,2013,83,Carrie,84790678 ,35266619 ,41.60,49524059 ,58.40
683,2013,84,Finding Mr. Right,84112033 ,6945 ,<0.1,84105088 ,100
684,2013,85,The Family,78418811 ,36918811 ,47.10,41500000 ,52.90
685,2013,86,Scary Movie 5,78378744 ,32015787 ,40.80,46362957 ,59.20
686,2013,87,R.I.P.D.,78324220 ,33618855 ,42.90,44705365 ,57.10
687,2013,88,Tiny Times,77717014 ,23462 ,<0.1,77693552 ,100
688,2013,89,The Book Thief,76586316 ,21488481 ,28.10,55097835 ,71.90
689,2013,90,Escape from Planet Earth,74597643 ,57012977 ,76.40,17584666 ,23.60
690,2013,91,August: Osage County,74188937 ,37738810 ,50.90,36450127 ,49.10
691,2013,92,The Best Man Holiday,72835710 ,70525195 ,96.80,2310515 ,3.20
692,2013,93,Young Detective Dee: Rise of the Sea Dragon,72287783 ,87783 ,0.10,72200000 ,99.90
693,2013,94,The Counsellor,71009334 ,16973715 ,23.90,54035619 ,76.10
694,2013,95,The Attorney,70567539 ,557236 ,0.80,70010303 ,99.20
695,2013,96,The Call,68572378 ,51872378 ,75.60,16700000 ,24.40
696,2013,97,One Direction: This Is Us,68532898 ,28873374 ,42.10,39659524 ,57.90
697,2013,98,Stalingrad,68129518 ,1013945 ,1.50,67115573 ,98.50
698,2013,99,Thunder and the House of Magic,64197205 ,4091 ,<0.1,64193114 ,100
699,2013,100,The Grandmaster,64076736 ,6594959 ,10.30,57481777 ,89.70
700,2012,1,The Avengers,1518812988 ,623357910 ,41,895455078 ,59
701,2012,2,Skyfall,1108561013 ,304360277 ,27.50,804200736 ,72.50
702,2012,3,The Dark Knight Rises,1081041287 ,448139099 ,41.50,632902188 ,58.50
703,2012,4,The Hobbit: An Unexpected Journey,1017003568 ,303003568 ,29.80,714000000 ,70.20
704,2012,5,Ice Age: Continental Drift,877244782 ,161321843 ,18.40,715922939 ,81.60
705,2012,6,The Twilight Saga: Breaking Dawn - Part 2,829746820 ,292324737 ,35.20,537422083 ,64.80
706,2012,7,The Amazing Spider-Man,757930663 ,262030663 ,34.60,495900000 ,65.40
707,2012,8,Madagascar 3: Europe's Most Wanted,746921274 ,216391482 ,29,530529792 ,71
708,2012,9,The Hunger Games,694394724 ,408010692 ,58.80,286384032 ,41.20
709,2012,10,Men in Black 3,624026776 ,179020854 ,28.70,445005922 ,71.30
710,2012,11,Life of Pi,609016565 ,124987023 ,20.50,484029542 ,79.50
711,2012,12,Ted,549368315 ,218815487 ,39.80,330552828 ,60.20
712,2012,13,Brave,538983207 ,237283207 ,44,301700000 ,56
713,2012,14,Wreck-It Ralph,471222889 ,189422889 ,40.20,281800000 ,59.80
714,2012,15,Les Mis√©rables,441809770 ,148809770 ,33.70,293000000 ,66.30
715,2012,16,Django Unchained,425368238 ,162805434 ,38.30,262562804 ,61.70
716,2012,17,Prometheus,403354469 ,126477084 ,31.40,276877385 ,68.60
717,2012,18,Snow White and the Huntsman,396592829 ,155332381 ,39.20,241260448 ,60.80
718,2012,19,Taken 2,376141306 ,139854287 ,37.20,236287019 ,62.80
719,2012,20,The Lorax,348840316 ,214030500 ,61.40,134809816 ,38.60
720,2012,21,Titanic 2012 3D Release,343550770 ,57884114 ,16.80,285666656 ,83.20
721,2012,22,Journey 2: The Mysterious Island,335260290 ,103860290 ,31,231400000 ,69
722,2012,23,The Expendables 2,314975955 ,85028192 ,27,229947763 ,73
723,2012,24,Rise of the Guardians,306941670 ,103412758 ,33.70,203528912 ,66.30
724,2012,25,Battleship,303025485 ,65422625 ,21.60,237602860 ,78.40
725,2012,26,Wrath of the Titans,301970083 ,83670083 ,27.70,218300000 ,72.30
726,2012,27,John Carter,284139100 ,73078100 ,25.70,211061000 ,74.30
727,2012,28,The Bourne Legacy,276144750 ,113203870 ,41,162940880 ,59
728,2012,29,Lincoln,275293450 ,182207973 ,66.20,93085477 ,33.80
729,2012,30,We're the Millers,269994119 ,150394119 ,55.70,119600000 ,44.30
730,2012,31,Dark Shadows,245527149 ,79727149 ,32.50,165800000 ,67.50
731,2012,32,Resident Evil: Retribution,240159255 ,42345531 ,17.60,197813724 ,82.40
732,2012,33,Silver Linings Playbook,236412453 ,132092958 ,55.90,104319495 ,44.10
733,2012,34,American Reunion,234989584 ,57011521 ,24.30,177978063 ,75.70
734,2012,35,Argo,232325503 ,136025503 ,58.50,96300000 ,41.50
735,2012,36,Jack Reacher,218340595 ,80070736 ,36.70,138269859 ,63.30
736,2012,37,Safe House,208076205 ,126373434 ,60.70,81702771 ,39.30
737,2012,38,21 Jump Street,201585328 ,138447667 ,68.70,63137661 ,31.30
738,2012,39,Total Recall,198467168 ,58877969 ,29.70,139589199 ,70.30
739,2012,40,The Impossible,198087212 ,19019882 ,9.60,179067330 ,90.40
740,2012,41,Lost in Thailand,197757387 ,57387 ,<0.1,197700000 ,100
741,2012,42,The Vow,196114570 ,125014030 ,63.70,71100540 ,36.30
742,2012,43,Mirror Mirror,183018522 ,64935167 ,35.50,118083355 ,64.50
743,2012,44,The Dictator,179379533 ,59650222 ,33.30,119729311 ,66.70
744,2012,45,Looper,176506819 ,66486205 ,37.70,110020614 ,62.30
745,2012,46,Magic Mike,167221571 ,113721571 ,68,53500000 ,32
746,2012,47,Flight,161772375 ,93772375 ,58,68000000 ,42
747,2012,48,Underworld Awakening,160112671 ,62321039 ,38.90,97791632 ,61.10
748,2012,49,This Means War,156491279 ,54760791 ,35,101730488 ,65
749,2012,50,Paranormal Activity 4,142802657 ,53885000 ,37.70,88917657 ,62.30
750,2012,51,Step Up Revolution,140470746 ,35074677 ,25,105396069 ,75
751,2012,52,The Best Exotic Marigold Hotel,136836156 ,46412041 ,33.90,90424115 ,66.10
752,2012,53,Last Vegas,134402450 ,63914167 ,47.60,70488283 ,52.40
753,2012,54,Zero Dark Thirty,132820716 ,95720716 ,72.10,37100000 ,27.90
754,2012,55,Ghost Rider: Spirit of Vengeance,132563930 ,51774002 ,39.10,80789928 ,60.90
755,2012,56,Cloud Atlas,130482868 ,27108272 ,20.80,103374596 ,79.20
756,2012,57,The Woman in Black,127730736 ,54333290 ,42.50,73397446 ,57.50
757,2012,58,Chronicle,126636097 ,64575175 ,51,62060922 ,49
758,2012,59,Walking with Dinosaurs 3D,126546518 ,36076121 ,28.50,90470397 ,71.50
759,2012,60,The Pirates! Band of Misfits,123054041 ,31051126 ,25.20,92002915 ,74.80
760,2012,61,Parental Guidance,119772232 ,77267296 ,64.50,42504936 ,35.50
761,2012,62,Abraham Lincoln: Vampire Hunter,116471580 ,37519139 ,32.20,78952441 ,67.80
762,2012,63,Pitch Perfect,115350426 ,65001093 ,56.40,50349333 ,43.60
763,2012,64,Hope Springs,114281051 ,63536011 ,55.60,50745040 ,44.40
764,2012,65,ParaNorman,107139399 ,56003051 ,52.30,51136348 ,47.70
765,2012,66,The Campaign,104907746 ,86907746 ,82.80,18000000 ,17.20
766,2012,67,Star Wars: Episode I - The Phantom Menace 2012 3D Release,102739593 ,43456382 ,42.30,59283211 ,57.70
767,2012,68,Project X,102731865 ,54731865 ,53.30,48000000 ,46.70
768,2012,69,The Devil Inside,101758490 ,53261944 ,52.30,48496546 ,47.70
769,2012,70,The Lucky One,99357138 ,60457138 ,60.80,38900000 ,39.20
770,2012,71,Contraband,96262212 ,66528000 ,69.10,29734212 ,30.90
771,2012,72,Think Like a Man,96070507 ,91547205 ,95.30,4523302 ,4.70
772,2012,73,This Is 40,88058786 ,67544505 ,76.70,20514281 ,23.30
773,2012,74,The Possession,85446075 ,49130154 ,57.50,36315921 ,42.50
774,2012,75,What to Expect When You're Expecting,84384002 ,41152203 ,48.80,43231799 ,51.20
775,2012,76,The Thieves,83519699 ,685839 ,0.80,82833860 ,99.20
776,2012,77,Savages,82966152 ,47382068 ,57.10,35584084 ,42.90
777,2012,78,Frankenweenie,81491068 ,35291068 ,43.30,46200000 ,56.70
778,2012,79,Act of Valor,81272766 ,70012847 ,86.10,11259919 ,13.90
779,2012,80,Masquerade,80762596 ,922921 ,1.10,79839675 ,98.90
780,2012,81,Sinister,77712439 ,48086903 ,61.90,29625536 ,38.10
781,2012,82,The Grey,77278331 ,51580236 ,66.70,25698095 ,33.30
782,2012,83,Diary of a Wimpy Kid: Dog Days,77112176 ,49008662 ,63.60,28103514 ,36.40
783,2012,84,To Rome with Love,73244881 ,16685867 ,22.80,56559014 ,77.20
784,2012,85,Here Comes the Boom,73100172 ,45290318 ,62,27809854 ,38
785,2012,86,Finding Nemo 2012 3D Release,72128283 ,41128283 ,57,31000000 ,43
786,2012,87,The Cabin in the Woods 2012 Re-release,69935600 ,42073277 ,60.20,27862323 ,39.80
787,2012,88,Anna Karenina,68929150 ,12816367 ,18.60,56112783 ,81.40
788,2012,89,The Watch,68267862 ,35353000 ,51.80,32914862 ,48.20
789,2012,90,Moonrise Kingdom,68263166 ,45512466 ,66.70,22750700 ,33.30
790,2012,91,Madea's Witness Protection,66899242 ,65653242 ,98.10,1246000 ,1.90
791,2012,92,Beauty and the Beast 2012 3D Release,62767829 ,47617067 ,75.90,15150762 ,24.10
792,2012,93,Evangelion: 3.0 You Can (Not) Redo,60487945 ,174945 ,0.30,60313000 ,99.70
793,2012,94,Quartet,59520298 ,18390117 ,30.90,41130181 ,69.10
794,2012,95,Rock of Ages,59418613 ,38518613 ,64.80,20900000 ,35.20
795,2012,96,That's My Boy,57719093 ,36931089 ,64,20788004 ,36
796,2012,97,The Odd Life of Timothy Green,56012642 ,51854875 ,92.60,4157767 ,7.40
797,2012,98,The Three Stooges,54819301 ,44338224 ,80.90,10481077 ,19.10
798,2012,99,The Five-Year Engagement,53909751 ,28835528 ,53.50,25074223 ,46.50
799,2012,100,Lawless,53676580 ,37400127 ,69.70,16276453 ,30.30
800,2011,1,Harry Potter and the Deathly Hallows: Part 2,1341511219 ,381011219 ,28.40,960500000 ,71.60
801,2011,2,Transformers: Dark of the Moon,1123794079 ,352390543 ,31.40,771403536 ,68.60
802,2011,3,Pirates of the Caribbean: On Stranger Tides,1045713802 ,241071802 ,23.10,804642000 ,76.90
803,2011,4,The Twilight Saga: Breaking Dawn - Part 1,712205856 ,281287133 ,39.50,430918723 ,60.50
804,2011,5,Mission: Impossible - Ghost Protocol,694713380 ,209397903 ,30.10,485315477 ,69.90
805,2011,6,Kung Fu Panda 2,665692281 ,165249063 ,24.80,500443218 ,75.20
806,2011,7,Fast Five,626137675 ,209837675 ,33.50,416300000 ,66.50
807,2011,8,The Hangover Part II,586764305 ,254464305 ,43.40,332300000 ,56.60
808,2011,9,The Smurfs,563749323 ,142614158 ,25.30,421135165 ,74.70
809,2011,10,Cars 2,559852396 ,191452396 ,34.20,368400000 ,65.80
810,2011,11,Puss in Boots,554987477 ,149260504 ,26.90,405726973 ,73.10
811,2011,12,Sherlock Holmes: A Game of Shadows,543848418 ,186848418 ,34.40,357000000 ,65.60
812,2011,13,Rio,483866518 ,143619809 ,29.70,340246709 ,70.30
813,2011,14,Rise of the Planet of the Apes,481800873 ,176760185 ,36.70,305040688 ,63.30
814,2011,15,Thor,449326618 ,181030624 ,40.30,268295994 ,59.70
815,2011,16,The Intouchables,426588510 ,10198820 ,2.40,416389690 ,97.60
816,2011,17,The Adventures of Tintin,373993951 ,77591831 ,20.70,296402120 ,79.30
817,2011,18,Captain America: The First Avenger,370569774 ,176654505 ,47.70,193915269 ,52.30
818,2011,19,Hotel Transylvania,358375603 ,148313048 ,41.40,210062555 ,58.60
819,2011,20,X-Men: First Class,352616690 ,146408305 ,41.50,206208385 ,58.50
820,2011,21,Alvin and the Chipmunks: Chipwrecked,342695435 ,133110742 ,38.80,209584693 ,61.20
821,2011,22,Real Steel,299268508 ,85468508 ,28.60,213800000 ,71.40
822,2011,23,Bridesmaids,288383523 ,169106725 ,58.60,119276798 ,41.40
823,2011,24,Super 8,260095986 ,127004179 ,48.80,133091807 ,51.20
824,2011,25,Rango,245724603 ,123477607 ,50.30,122246996 ,49.70
825,2011,26,The Girl with the Dragon Tattoo,232617430 ,102515793 ,44.10,130101637 ,55.90
826,2011,27,The Green Hornet,227817248 ,98780042 ,43.40,129037206 ,56.60
827,2011,28,Immortals,226904017 ,83504017 ,36.80,143400000 ,63.20
828,2011,29,Green Lantern,219851172 ,116601172 ,53,103250000 ,47
829,2011,30,The Help,216639112 ,169708112 ,78.30,46931000 ,21.70
830,2011,31,Bad Teacher,216197492 ,100292856 ,46.40,115904636 ,53.60
831,2011,32,Just Go with It,214945591 ,103028109 ,47.90,111917482 ,52.10
832,2011,33,Battle Los Angeles,211819354 ,83552429 ,39.40,128266925 ,60.60
833,2011,34,Horrible Bosses,209838559 ,117538559 ,56,92300000 ,44
834,2011,35,Paranormal Activity 3,207039844 ,104028807 ,50.20,103011037 ,49.80
835,2011,36,Gnomeo & Juliet,193967670 ,99967670 ,51.50,94000000 ,48.50
836,2011,37,Mr. Popper's Penguins,187361754 ,68224452 ,36.40,119137302 ,63.60
837,2011,38,Hugo,185770160 ,73864507 ,39.80,111905653 ,60.20
838,2011,39,The Lion King 2011 3D Release,185542001 ,94242001 ,50.80,91300000 ,49.20
839,2011,40,Hop,183953723 ,108085305 ,58.80,75868418 ,41.20
840,2011,41,War Horse,177584879 ,79884879 ,45,97700000 ,55
841,2011,42,The Descendants,177243185 ,82584160 ,46.60,94659025 ,53.40
842,2011,43,Cowboys & Aliens,174822325 ,100240551 ,57.30,74581774 ,42.70
843,2011,44,In Time,173930596 ,37520095 ,21.60,136410501 ,78.40
844,2011,45,Zookeeper,169852759 ,80360843 ,47.30,89491916 ,52.70
845,2011,46,The Muppets,165184237 ,88631237 ,53.70,76553000 ,46.30
846,2011,47,Limitless,161849455 ,79249455 ,49,82600000 ,51
847,2011,48,Johnny English Reborn,160078586 ,8305970 ,5.20,151772616 ,94.80
848,2011,49,Final Destination 5,157887643 ,42587643 ,27,115300000 ,73
849,2011,50,Tower Heist,152930623 ,78046570 ,51,74884053 ,49
850,2011,51,Midnight in Paris,151119219 ,56817045 ,37.60,94302174 ,62.40
851,2011,52,Happy Feet Two,150406466 ,64006466 ,42.60,86400000 ,57.40
852,2011,53,I Am Number Four,149878437 ,55100437 ,36.80,94778000 ,63.20
853,2011,54,Jack and Jill,149673788 ,74158157 ,49.50,75515631 ,50.50
854,2011,55,Friends with Benefits,149542245 ,55802754 ,37.30,93739491 ,62.70
855,2011,56,No Strings Attached,149228077 ,70662220 ,47.40,78565857 ,52.60
856,2011,57,Arthur Christmas,147419472 ,46462469 ,31.50,100957003 ,68.50
857,2011,58,Source Code,147332697 ,54712227 ,37.10,92620470 ,62.90
858,2011,59,"Crazy, Stupid, Love.",145051197 ,84351197 ,58.20,60700000 ,41.80
859,2011,60,New Year's Eve,142044638 ,54544638 ,38.40,87500000 ,61.60
860,2011,61,Contagion,135458097 ,75658097 ,55.90,59800000 ,44.10
861,2011,62,The Artist,133432856 ,44671682 ,33.50,88761174 ,66.50
862,2011,63,The Three Musketeers,132274484 ,20374484 ,15.40,111900000 ,84.60
863,2011,64,Unknown,130786397 ,63686397 ,48.70,67100000 ,51.30
864,2011,65,We Bought a Zoo,120081841 ,75624550 ,63,44457291 ,37
865,2011,66,Water for Elephants,117094902 ,58709717 ,50.10,58385185 ,49.90
866,2011,67,The Iron Lady,114956699 ,30017992 ,26.10,84938707 ,73.90
867,2011,68,Moneyball,110206216 ,75605492 ,68.60,34600724 ,31.40
868,2011,69,Justin Bieber: Never Say Never,99036827 ,73013910 ,73.70,26022917 ,26.30
869,2011,70,Paul,97984015 ,37412945 ,38.20,60571070 ,61.80
870,2011,71,Scream 4,97138686 ,38180928 ,39.30,58957758 ,60.70
871,2011,72,Insidious,97009150 ,54009150 ,55.70,43000000 ,44.30
872,2011,73,The Rite,96047633 ,33047633 ,34.40,63000000 ,65.60
873,2011,74,Dolphin Tale,95404397 ,72286779 ,75.80,23117618 ,24.20
874,2011,75,Season of the Witch,91627228 ,24827228 ,27.10,66800000 ,72.90
875,2011,76,Nothing to Declare,90000000 ,,,90000000 ,100
876,2011,77,Sucker Punch,89792502 ,36392502 ,40.50,53400000 ,59.50
877,2011,78,Red Riding Hood,89162162 ,37662162 ,42.20,51500000 ,57.80
878,2011,79,The Inbetweeners Movie,88025781 ,36000 ,<0.1,87989781 ,100
879,2011,80,Spy Kids 4-D: All the Time in the World,85564310 ,38538188 ,45,47026122 ,55
880,2011,81,J. Edgar,84920539 ,37306030 ,43.90,47614509 ,56.10
881,2011,82,Hall Pass,83160734 ,45060734 ,54.20,38100000 ,45.80
882,2011,83,"Big Mommas: Like Father, Like Son",82686066 ,37915414 ,45.90,44770652 ,54.10
883,2011,84,Abduction,82087155 ,28087155 ,34.20,54000000 ,65.80
884,2011,85,Tinker Tailor Soldier Spy,80630608 ,24149393 ,30,56481215 ,70
885,2011,86,Priest,78309505 ,29137000 ,37.20,49172505 ,62.80
886,2011,87,Drive,76176032 ,35061555 ,46,41114477 ,54
887,2011,88,The Mechanic,76129642 ,29121498 ,38.30,47008144 ,61.70
888,2011,89,The Ides of March,75993061 ,40962534 ,53.90,35030527 ,46.10
889,2011,90,The Change-Up,75450437 ,37081475 ,49.10,38368962 ,50.90
890,2011,91,The Lincoln Lawyer,75009200 ,58009200 ,77.30,17000000 ,22.70
891,2011,92,Diary of a Wimpy Kid: Rodrick Rules,72417394 ,52698535 ,72.80,19718859 ,27.20
892,2011,93,Larry Crowne,72008245 ,35608245 ,49.50,36400000 ,50.50
893,2011,94,The Dilemma,69721966 ,48475290 ,69.50,21246676 ,30.50
894,2011,95,The Darkest Hour,64626786 ,21443494 ,33.20,43183292 ,66.80
895,2011,96,Hanna,63782078 ,40259119 ,63.10,23522959 ,36.90
896,2011,97,Footloose 2011 Re-release,63543328 ,51802742 ,81.50,11740586 ,18.50
897,2011,98,From Up on Poppy Hill,61037844 ,1002895 ,1.60,60034949 ,98.40
898,2011,99,Colombiana,60965854 ,36665854 ,60.10,24300000 ,39.90
899,2011,100,Something Borrowed,60183821 ,39046489 ,64.90,21137332 ,35.10
900,2010,1,Toy Story 3,1066969703 ,415004880 ,38.90,651964823 ,61.10
901,2010,2,Alice in Wonderland,1025467110 ,334191110 ,32.60,691276000 ,67.40
902,2010,3,Harry Potter and the Deathly Hallows: Part 1,960283305 ,295983305 ,30.80,664300000 ,69.20
903,2010,4,Inception,828322032 ,292576195 ,35.30,535745837 ,64.70
904,2010,5,Shrek Forever After,752600867 ,238736787 ,31.70,513864080 ,68.30
905,2010,6,The Twilight Saga: Eclipse,698491347 ,300531751 ,43,397959596 ,57
906,2010,7,Iron Man 2,623933331 ,312433331 ,50.10,311500000 ,49.90
907,2010,8,Tangled,591794936 ,200821936 ,33.90,390973000 ,66.10
908,2010,9,Despicable Me,543113985 ,251513985 ,46.30,291600000 ,53.70
909,2010,10,How to Train Your Dragon,494878759 ,217581231 ,44,277297528 ,56
910,2010,11,Clash of the Titans,493214993 ,163214888 ,33.10,330000105 ,66.90
911,2010,12,The Chronicles of Narnia: The Voyage of the Dawn Treader,415686217 ,104386950 ,25.10,311299267 ,74.90
912,2010,13,The King's Speech,410867243 ,135453143 ,33,275414100 ,67
913,2010,14,TRON: Legacy,400062763 ,172062763 ,43,228000000 ,57
914,2010,15,The Karate Kid,359126022 ,176591618 ,49.20,182534404 ,50.80
915,2010,16,Black Swan,329398046 ,106954678 ,32.50,222443368 ,67.50
916,2010,17,Megamind,321885765 ,148415853 ,46.10,173469912 ,53.90
917,2010,18,Robin Hood,321669741 ,105269730 ,32.70,216400011 ,67.30
918,2010,19,The Last Airbender,319713881 ,131772187 ,41.20,187941694 ,58.80
919,2010,20,Little Fockers,310650585 ,148438600 ,47.80,162211985 ,52.20
920,2010,21,Resident Evil: Afterlife,300228084 ,60128566 ,20,240099518 ,80
921,2010,22,Shutter Island,294804195 ,128012934 ,43.40,166791261 ,56.60
922,2010,23,Salt,293503354 ,118311368 ,40.30,175191986 ,59.70
923,2010,24,Sex and the City 2,288347692 ,95347692 ,33.10,193000000 ,66.90
924,2010,25,The Tourist,278346189 ,67631157 ,24.30,210715032 ,75.70
925,2010,26,The Expendables,274470394 ,103068524 ,37.60,171401870 ,62.40
926,2010,27,Grown Ups,271430189 ,162001186 ,59.70,109429003 ,40.30
927,2010,28,Knight and Day 2010 Re-release,261930436 ,76423035 ,29.20,185507401 ,70.80
928,2010,29,True Grit,252276927 ,171243005 ,67.90,81033922 ,32.10
929,2010,30,Gulliver's Travels,237382724 ,42779261 ,18,194603463 ,82
930,2010,31,Percy Jackson & the Olympians: The Lightning Thief,226497209 ,88768303 ,39.20,137728906 ,60.80
931,2010,32,The Social Network,224920315 ,96962694 ,43.10,127957621 ,56.90
932,2010,33,Valentine's Day,216485654 ,110485654 ,51,106000000 ,49
933,2010,34,The Sorcerer's Apprentice,215283742 ,63150991 ,29.30,152132751 ,70.70
934,2010,35,Due Date,211780824 ,100539043 ,47.50,111241781 ,52.50
935,2010,36,Eat Pray Love,204594016 ,80574010 ,39.40,124020006 ,60.60
936,2010,37,Yogi Bear,201584141 ,100246011 ,49.70,101338130 ,50.30
937,2010,38,RED,199006387 ,90380162 ,45.40,108626225 ,54.60
938,2010,39,Paranormal Activity 2,177512032 ,84752907 ,47.70,92759125 ,52.30
939,2010,40,The A-Team,177238796 ,77222099 ,43.60,100016697 ,56.40
940,2010,41,Jackass 3D,171685792 ,117229692 ,68.30,54456100 ,31.70
941,2010,42,The Other Guys,170432927 ,119219978 ,70,51212949 ,30
942,2010,43,Unstoppable,167805466 ,81562942 ,48.60,86242524 ,51.40
943,2010,44,Step Up 3D,159291809 ,42400223 ,26.60,116891586 ,73.40
944,2010,45,The Book of Eli,157107755 ,94835059 ,60.40,62272696 ,39.60
945,2010,46,The Town,154026136 ,92186262 ,59.90,61839874 ,40.10
946,2010,47,Date Night,152263880 ,98711404 ,64.80,53552476 ,35.20
947,2010,48,The Secret World of Arrietty,145570827 ,19202743 ,13.20,126368084 ,86.80
948,2010,49,Legend of the Guardians: The Owls of Ga'Hoole,140073390 ,55675313 ,39.70,84398077 ,60.30
949,2010,50,The Wolfman,139789765 ,61979680 ,44.30,77810085 ,55.70
950,2010,51,The Bounty Hunter,136333522 ,67061228 ,49.20,69272294 ,50.80
951,2010,52,Saw: The Final Chapter,136150434 ,45710178 ,33.60,90440256 ,66.40
952,2010,53,Wall Street: Money Never Sleeps,134748021 ,52474616 ,38.90,82273405 ,61.10
953,2010,54,The Adjustment Bureau,127869379 ,62495645 ,48.90,65373734 ,51.10
954,2010,55,Predators,127233108 ,52000688 ,40.90,75232420 ,59.10
955,2010,56,A Nightmare on Elm Street,115664037 ,63075011 ,54.50,52589026 ,45.50
956,2010,57,Dear John,114977104 ,80014842 ,69.60,34962262 ,30.40
957,2010,58,Cats & Dogs: The Revenge of Kitty Galore,112483764 ,43585753 ,38.70,68898011 ,61.30
958,2010,59,Tooth Fairy,112462508 ,60022256 ,53.40,52440252 ,46.60
959,2010,60,Sanctum,108609310 ,23209310 ,21.40,85400000 ,78.60
960,2010,61,Life as We Know It,105648706 ,53374681 ,50.50,52274025 ,49.50
961,2010,62,Hereafter,105197635 ,32746941 ,31.10,72450694 ,68.90
962,2010,63,Let the Bullets Fly,104336887 ,63012 ,<0.1,104273875 ,99.90
963,2010,64,Love & Other Drugs,102820008 ,32367005 ,31.50,70453003 ,68.50
964,2010,65,Aftershock,100292829 ,62962 ,<0.1,100229867 ,99.90
965,2010,66,Killers,98159963 ,47059963 ,47.90,51100000 ,52.10
966,2010,67,Kick-Ass,96188903 ,48071303 ,50,48117600 ,50
967,2010,68,Nanny McPhee Returns,93251121 ,29011215 ,31.10,64239906 ,68.90
968,2010,69,Get Him to the Greek,91261479 ,60974475 ,66.80,30287004 ,33.20
969,2010,70,Burlesque,89519773 ,39440655 ,44.10,50079118 ,55.90
970,2010,71,The Last Song,89041656 ,62950384 ,70.70,26091272 ,29.30
971,2010,72,Dinner for Schmucks,86855739 ,73026337 ,84.10,13829402 ,15.90
972,2010,73,Marmaduke,83761844 ,33644788 ,40.20,50117056 ,59.80
973,2010,74,Piranha 3D,83188165 ,25003155 ,30.10,58185010 ,69.90
974,2010,75,Oceans 2010 Re-release,82651439 ,19422319 ,23.50,63229120 ,76.50
975,2010,76,Edge of Darkness,81124129 ,43313890 ,53.40,37810239 ,46.60
976,2010,77,Vampires Suck,80547866 ,36661504 ,45.50,43886362 ,54.50
977,2010,78,Letters to Juliet,79181750 ,53032453 ,67,26149297 ,33
978,2010,79,The Back-up Plan,77477008 ,37490007 ,48.40,39987001 ,51.60
979,2010,80,If You Are the One 2,76070352 ,426894 ,0.60,75643458 ,99.40
980,2010,81,Diary of a Wimpy Kid,75700498 ,64003625 ,84.50,11696873 ,15.50
981,2010,82,Easy A,74952305 ,58401464 ,77.90,16550841 ,22.10
982,2010,83,Hubble 3D,74162771 ,52499620 ,70.80,21663151 ,29.20
983,2010,84,Takers,69055695 ,57744720 ,83.60,11310975 ,16.40
984,2010,85,Legion,67918658 ,40168080 ,59.10,27750578 ,40.90
985,2010,86,The American,67876281 ,35606376 ,52.50,32269905 ,47.50
986,2010,87,The Last Exorcism,67738090 ,41034350 ,60.60,26703740 ,39.40
987,2010,88,The Next Three Days,67448651 ,21148651 ,31.40,46300000 ,68.60
988,2010,89,Skyline,66821036 ,21393620 ,32,45427416 ,68
989,2010,90,Hot Tub Time Machine,64572262 ,50287556 ,77.90,14284706 ,22.10
990,2010,91,Elite Squad: The Enemy Within,63027681 ,100119 ,0.20,62927562 ,99.80
991,2010,92,Devil,62695489 ,33601190 ,53.60,29094299 ,46.40
992,2010,93,127 Hours,60738797 ,18335230 ,30.20,42403567 ,69.80
993,2010,94,Why Did I Get Married Too?,60673972 ,60095852 ,99,578120 ,1
994,2010,95,Secretariat,60251371 ,59713955 ,99.10,537416 ,0.90
995,2010,96,The Ghost Writer,60222298 ,15541549 ,25.80,44680749 ,74.20
996,2010,97,Morning Glory,60040976 ,31011732 ,51.70,29029244 ,48.30
997,2010,98,Remember Me,56032889 ,19068240 ,34,36964649 ,66
998,2010,99,Cop Out,55583804 ,44875481 ,80.70,10708323 ,19.30
999,2010,100,The Crazies,54806823 ,39123589 ,71.40,15683234 ,28.60
1000,2009,1,Avatar,2743856300 ,749766139 ,27.30,1994090161 ,72.70
1001,2009,2,Harry Potter and the Half-Blood Prince,933959197 ,301959197 ,32.30,632000000 ,67.70
1002,2009,3,Ice Age: Dawn of the Dinosaurs,886686817 ,196573705 ,22.20,690113112 ,77.80
1003,2009,4,Transformers: Revenge of the Fallen,836303693 ,402111870 ,48.10,434191823 ,51.90
1004,2009,5,2012,769679473 ,166112167 ,21.60,603567306 ,78.40
1005,2009,6,Up,735099082 ,293004164 ,39.90,442094918 ,60.10
1006,2009,7,The Twilight Saga: New Moon,709827462 ,296623634 ,41.80,413203828 ,58.20
1007,2009,8,Sherlock Holmes,524028679 ,209028679 ,39.90,315000000 ,60.10
1008,2009,9,Angels & Demons,485930816 ,133375846 ,27.40,352554970 ,72.60
1009,2009,10,The Hangover,467483912 ,277322503 ,59.30,190161409 ,40.70
1010,2009,11,Alvin and the Chipmunks: The Squeakquel,443140005 ,219614612 ,49.60,223525393 ,50.40
1011,2009,12,Night at the Museum: Battle of the Smithsonian,413106170 ,177243721 ,42.90,235862449 ,57.10
1012,2009,13,Star Trek,385680446 ,257730019 ,66.80,127950427 ,33.20
1013,2009,14,Monsters vs. Aliens,381509870 ,198351526 ,52,183158344 ,48
1014,2009,15,X-Men Origins: Wolverine,373062864 ,179883157 ,48.20,193179707 ,51.80
1015,2009,16,Terminator Salvation,371353001 ,125322469 ,33.70,246030532 ,66.30
1016,2009,17,Fast & Furious,360364265 ,155064265 ,43,205300000 ,57
1017,2009,18,Prince of Persia: The Sands of Time,336365676 ,90759676 ,27,245606000 ,73
1018,2009,19,A Christmas Carol,325286646 ,137855863 ,42.40,187430783 ,57.60
1019,2009,20,Inglourious Basterds,321455689 ,120540719 ,37.50,200914970 ,62.50
1020,2009,21,The Proposal,317375031 ,163958031 ,51.70,153417000 ,48.30
1021,2009,22,The Blind Side,309208309 ,255959475 ,82.80,53248834 ,17.20
1022,2009,23,G.I. Joe: The Rise of Cobra,302469017 ,150201498 ,49.70,152267519 ,50.30
1023,2009,24,G-Force,292817841 ,119436770 ,40.80,173381071 ,59.20
1024,2009,25,The Princess and the Frog,267045765 ,104400899 ,39.10,162644866 ,60.90
1025,2009,26,This Is It,261183588 ,72091016 ,27.60,189092572 ,72.40
1026,2009,27,Cloudy with a Chance of Meatballs,243006126 ,124870275 ,51.40,118135851 ,48.60
1027,2009,28,It's Complicated,219103655 ,112735375 ,51.50,106368280 ,48.50
1028,2009,29,Public Enemies,214104620 ,97104620 ,45.40,117000000 ,54.60
1029,2009,30,District 9,210819611 ,115646235 ,54.90,95173376 ,45.10
1030,2009,31,The Ugly Truth,205298907 ,88915214 ,43.30,116383693 ,56.70
1031,2009,32,Paranormal Activity,193355800 ,107918810 ,55.80,85436990 ,44.20
1032,2009,33,The Final Destination,186167139 ,66477700 ,35.70,119689439 ,64.30
1033,2009,34,Watchmen,185258983 ,107509799 ,58,77749184 ,42
1034,2009,35,Knowing 2009 Re-release,183410848 ,79957634 ,43.60,103453214 ,56.40
1035,2009,36,Paul Blart: Mall Cop,183293131 ,146336178 ,79.80,36956953 ,20.20
1036,2009,37,He's Just Not That Into You,178846899 ,93953653 ,52.50,84893246 ,47.50
1037,2009,38,Couples Retreat,171844840 ,109204945 ,63.50,62639895 ,36.50
1038,2009,39,Up in the Air,166842739 ,83823381 ,50.20,83019358 ,49.80
1039,2009,40,Hannah Montana: The Movie,155545279 ,79576189 ,51.20,75969090 ,48.80
1040,2009,41,The Taking of Pelham 123,150166126 ,65452312 ,43.60,84713814 ,56.40
1041,2009,42,Br√ºno,138805831 ,60054530 ,43.30,78751301 ,56.70
1042,2009,43,17 Again,136267476 ,64167069 ,47.10,72100407 ,52.90
1043,2009,44,Julie & Julia,129540499 ,94125426 ,72.70,35415073 ,27.30
1044,2009,45,The Fighter,129190869 ,93617009 ,72.50,35573860 ,27.50
1045,2009,46,Law Abiding Citizen,126690726 ,73357727 ,57.90,53332999 ,42.10
1046,2009,47,Coraline,124596398 ,75286229 ,60.40,49310169 ,39.60
1047,2009,48,Surrogates,122444772 ,38577772 ,31.50,83867000 ,68.50
1048,2009,49,Invictus,122233971 ,37491364 ,30.70,84742607 ,69.30
1049,2009,50,Hotel for Dogs,117000198 ,73034460 ,62.40,43965738 ,37.60
1050,2009,51,Bride Wars,115154152 ,58715510 ,51,56438642 ,49
1051,2009,52,Confessions of a Shopaholic,108333222 ,44277350 ,40.90,64055872 ,59.10
1052,2009,53,Race to Witch Mountain,106387141 ,67172594 ,63.10,39214547 ,36.90
1053,2009,54,Planet 51,105647102 ,42194060 ,39.90,63453042 ,60.10
1054,2009,55,The Girl with the Dragon Tattoo,104395170 ,10095170 ,9.70,94300000 ,90.30
1055,2009,56,Zombieland,102392080 ,75590286 ,73.80,26801794 ,26.20
1056,2009,57,Ghosts of Girlfriends Past,102223269 ,55250026 ,54,46973243 ,46
1057,2009,58,The Time Traveler's Wife,101344412 ,63414846 ,62.60,37929566 ,37.40
1058,2009,59,My Bloody Valentine,100734718 ,51545952 ,51.20,49188766 ,48.80
1059,2009,60,Where the Wild Things Are,100086793 ,77233467 ,77.20,22853326 ,22.80
1060,2009,61,Old Dogs,96753696 ,49492060 ,51.20,47261636 ,48.80
1061,2009,62,My Sister's Keeper,95714875 ,49200230 ,51.40,46514645 ,48.60
1062,2009,63,Green Zone,94882549 ,35053660 ,36.90,59828889 ,63.10
1063,2009,64,The Lovely Bones,93621340 ,44114232 ,47.10,49507108 ,52.90
1064,2009,65,"I Love You, Man",91636986 ,71440011 ,78,20196975 ,22
1065,2009,66,Friday the 13th,91379051 ,65002019 ,71.10,26377032 ,28.90
1066,2009,67,Underworld: Rise of the Lycans,91353501 ,45802315 ,50.10,45551186 ,49.90
1067,2009,68,Drag Me to Hell,90842646 ,42100625 ,46.30,48742021 ,53.70
1068,2009,69,Madea Goes to Jail,90508336 ,90508336 ,100,,
1069,2009,70,State of Play,87812371 ,37017955 ,42.20,50794416 ,57.80
1070,2009,71,Did You Hear About the Morgans?,85280250 ,29580087 ,34.70,55700163 ,65.30
1071,2009,72,Duplicity,78146652 ,40572825 ,51.90,37573827 ,48.10
1072,2009,73,Fame,77211836 ,22455510 ,29.10,54756326 ,70.90
1073,2009,74,The Haunting in Connecticut 2009 Re-release,77099821 ,55389516 ,71.80,21710305 ,28.20
1074,2009,75,Orphan,76699632 ,41596251 ,54.20,35103381 ,45.80
1075,2009,76,The Unborn,76514050 ,42670410 ,55.80,33843640 ,44.20
1076,2009,77,The Pink Panther 2,75946615 ,35922978 ,47.30,40023637 ,52.70
1077,2009,78,Obsessed,73830340 ,68261644 ,92.50,5568696 ,7.50
1078,2009,79,Funny People,71585235 ,51855045 ,72.40,19730190 ,27.60
1079,2009,80,The Men Who Stare at Goats,68968688 ,32428195 ,47,36540493 ,53
1080,2009,81,Land of the Lost,68777554 ,49438370 ,71.90,19339184 ,28.10
1081,2009,82,Saw VI,68233629 ,27693292 ,40.60,40540337 ,59.40
1082,2009,83,The Girl Who Played with Fire,67126795 ,7638241 ,11.40,59488554 ,88.60
1083,2009,84,Precious,63647833 ,47566524 ,74.70,16081309 ,25.30
1084,2009,85,Year One,62357900 ,43337279 ,69.50,19020621 ,30.50
1085,2009,86,The Imaginarium of Doctor Parnassus,61808775 ,7689607 ,12.40,54119168 ,87.60
1086,2009,87,Ninja Assassin,61601280 ,38122883 ,61.90,23478397 ,38.10
1087,2009,88,500 Days of Summer,60722734 ,32391374 ,53.30,28331360 ,46.70
1088,2009,89,The International,60161391 ,25450527 ,42.30,34710864 ,57.70
1089,2009,90,Aliens in the Attic,57881056 ,25200412 ,43.50,32680644 ,56.50
1090,2009,91,Under the Sea 3D,55845991 ,36213909 ,64.80,19632082 ,35.20
1091,2009,92,Dragonball Evolution,55720772 ,9362785 ,16.80,46357987 ,83.20
1092,2009,93,Nine,53998806 ,19676965 ,36.40,34321841 ,63.60
1093,2009,94,I Can Do Bad All by Myself,51733921 ,51733921 ,100,,
1094,2009,95,Coco Before Chanel,50812934 ,6113834 ,12,44699100 ,88
1095,2009,96,Push,48858618 ,31811527 ,65.10,17047091 ,34.90
1096,2009,97,9,48428063 ,31749894 ,65.60,16678169 ,34.40
1097,2009,98,The Fourth Kind,47709193 ,25486040 ,53.40,22223153 ,46.60
1098,2009,99,Crazy Heart,47405566 ,39464306 ,83.20,7941260 ,16.80
1099,2009,100,Fantastic Mr. Fox,46471023 ,21002919 ,45.20,25468104 ,54.80
1100,2008,1,The Dark Knight,1003045358 ,533345358 ,53.20,469700000 ,46.80
1101,2008,2,Indiana Jones and the Kingdom of the Crystal Skull,786636033 ,317101119 ,40.30,469534914 ,59.70
1102,2008,3,Kung Fu Panda,631744560 ,215434591 ,34.10,416309969 ,65.90
1103,2008,4,Hancock,624386771 ,227946274 ,36.50,396440497 ,63.50
1104,2008,5,Mamma Mia!,609841637 ,144130063 ,23.60,465711574 ,76.40
1105,2008,6,Madagascar: Escape 2 Africa,603900354 ,180010950 ,29.80,423889404 ,70.20
1106,2008,7,Quantum of Solace,586090727 ,168368427 ,28.70,417722300 ,71.30
1107,2008,8,Iron Man,585366247 ,318604126 ,54.40,266762121 ,45.60
1108,2008,9,WALL¬∑E,521311860 ,223808164 ,42.90,297503696 ,57.10
1109,2008,10,The Chronicles of Narnia: Prince Caspian,419665568 ,141621490 ,33.70,278044078 ,66.30
1110,2008,11,Sex and the City,415253641 ,152647258 ,36.80,262606383 ,63.20
1111,2008,12,The Mummy: Tomb of the Dragon Emperor,403449830 ,102491776 ,25.40,300958054 ,74.60
1112,2008,13,Twilight,392616625 ,192769854 ,49.10,199846771 ,50.90
1113,2008,14,Slumdog Millionaire,377910544 ,141319928 ,37.40,236590616 ,62.60
1114,2008,15,Wanted,341432090 ,134508551 ,39.40,206923539 ,60.60
1115,2008,16,The Curious Case of Benjamin Button,333932083 ,127509326 ,38.20,206422757 ,61.80
1116,2008,17,Bolt,309979994 ,114053579 ,36.80,195926415 ,63.20
1117,2008,18,Horton Hears a Who!,297138014 ,154529439 ,52,142608575 ,48
1118,2008,19,Gran Torino,269958228 ,148095302 ,54.90,121862926 ,45.10
1119,2008,20,"10,000 BC",269784201 ,94784201 ,35.10,175000000 ,64.90
1120,2008,21,The Incredible Hulk,263427551 ,134806913 ,51.20,128620638 ,48.80
1121,2008,22,Marley & Me,255743093 ,143153751 ,56,112589342 ,44
1122,2008,23,High School Musical 3: Senior Year,252909177 ,90559416 ,35.80,162349761 ,64.20
1123,2008,24,Welcome to the Sticks,245144417 ,,,245144417 ,100
1124,2008,25,Journey to the Center of the Earth,241995151 ,101704370 ,42,140290781 ,58
1125,2008,26,The Day the Earth Stood Still,233093859 ,79366978 ,34,153726881 ,66
1126,2008,27,Get Smart,230685453 ,130319208 ,56.50,100366245 ,43.50
1127,2008,28,Taken,226830568 ,145000989 ,63.90,81829579 ,36.10
1128,2008,29,Yes Man,223241637 ,97690976 ,43.80,125550661 ,56.20
1129,2008,30,Jumper,222231186 ,80172128 ,36.10,142059058 ,63.90
1130,2008,31,What Happens in Vegas,219375562 ,80277646 ,36.60,139097916 ,63.40
1131,2008,32,Bedtime Stories,212874864 ,110101975 ,51.70,102772889 ,48.30
1132,2008,33,Australia,211368784 ,49554002 ,23.40,161814782 ,76.60
1133,2008,34,Ponyo,201750937 ,15090399 ,7.50,186660538 ,92.50
1134,2008,35,Valkyrie,200292390 ,83077833 ,41.50,117214557 ,58.50
1135,2008,36,You Don't Mess with the Zohan,199936011 ,100018837 ,50,99917174 ,50
1136,2008,37,Tropic Thunder,188072649 ,110515313 ,58.80,77557336 ,41.20
1137,2008,38,Eagle Eye,178066569 ,101440743 ,57,76625826 ,43
1138,2008,39,Cloverfield,170764026 ,80048433 ,46.90,90715593 ,53.10
1139,2008,40,Seven Pounds,168168201 ,69951824 ,41.60,98216377 ,58.40
1140,2008,41,Four Christmases,163733697 ,120146040 ,73.40,43587657 ,26.60
1141,2008,42,Burn After Reading,163720069 ,60355347 ,36.90,103364722 ,63.10
1142,2008,43,The Happening,163403799 ,64506874 ,39.50,98896925 ,60.50
1143,2008,44,The Spiderwick Chronicles,162839667 ,71195053 ,43.70,91644614 ,56.30
1144,2008,45,Hellboy II: The Golden Army,160388063 ,75986503 ,47.40,84401560 ,52.60
1145,2008,46,27 Dresses,160259319 ,76808654 ,47.90,83450665 ,52.10
1146,2008,47,21,157927340 ,81159365 ,51.40,76767975 ,48.60
1147,2008,48,Vantage Point,151161491 ,72266306 ,47.80,78895185 ,52.20
1148,2008,49,Step Up 2: The Streets,150816700 ,58017783 ,38.50,92798917 ,61.50
1149,2008,50,Beverly Hills Chihuahua,149281606 ,94514402 ,63.30,54767204 ,36.70
1150,2008,51,Step Brothers,128107642 ,100468793 ,78.40,27638849 ,21.60
1151,2008,52,The Forbidden Kingdom,127980002 ,52075270 ,40.70,75904732 ,59.30
1152,2008,53,Red Cliff,127814609 ,627047 ,0.50,127187562 ,99.50
1153,2008,54,Body of Lies,115900897 ,39394666 ,34,76506231 ,66
1154,2008,55,Saw V,113864059 ,56746769 ,49.80,57117290 ,50.20
1155,2008,56,Rambo,113244290 ,42754105 ,37.80,70490185 ,62.20
1156,2008,57,Changeling,113020256 ,35739802 ,31.60,77280454 ,68.40
1157,2008,58,Fool's Gold,111231041 ,70231041 ,63.10,41000000 ,36.90
1158,2008,59,Transporter 3,108979549 ,31715062 ,29.10,77264487 ,70.90
1159,2008,60,The Reader,108901967 ,34194407 ,31.40,74707560 ,68.60
1160,2008,61,Made of Honor,105962760 ,46012734 ,43.40,59950026 ,56.60
1161,2008,62,Forgetting Sarah Marshall,105173115 ,63172463 ,60.10,42000652 ,39.90
1162,2008,63,Pineapple Express,101624843 ,87341380 ,85.90,14283463 ,14.10
1163,2008,64,Nim's Island,100076342 ,48006762 ,48,52069580 ,52
1164,2008,65,Vicky Cristina Barcelona,96409300 ,23216709 ,24.10,73192591 ,75.90
1165,2008,66,Speed Racer,93945766 ,43945766 ,46.80,50000000 ,53.20
1166,2008,67,Role Models,92380927 ,67294270 ,72.80,25086657 ,27.20
1167,2008,68,The Tale of Despereaux,86947965 ,50877145 ,58.50,36070820 ,41.50
1168,2008,69,Max Payne,85416905 ,40689393 ,47.60,44727512 ,52.40
1169,2008,70,Meet the Spartans,84646831 ,38233676 ,45.20,46413155 ,54.80
1170,2008,71,Nights in Rodanthe,84375346 ,41850659 ,49.60,42524687 ,50.40
1171,2008,72,The Strangers,82391145 ,52597610 ,63.80,29793535 ,36.20
1172,2008,73,Righteous Kill,78460699 ,40081410 ,51.10,38379289 ,48.90
1173,2008,74,The Other Boleyn Girl,77713866 ,26814957 ,34.50,50898909 ,65.50
1174,2008,75,Mirrors,77488607 ,30691439 ,39.60,46797168 ,60.40
1175,2008,76,Death Race,75677515 ,36316032 ,48,39361483 ,52
1176,2008,77,Revolutionary Road,75226021 ,22911480 ,30.50,52314541 ,69.50
1177,2008,78,Babylon A.D.,72109200 ,22532572 ,31.20,49576628 ,68.80
1178,2008,79,Superhero Movie,71239186 ,25881068 ,36.30,45358118 ,63.70
1179,2008,80,Hannah Montana and Miley Cyrus: Best of Both Worlds Concert,70642036 ,65281781 ,92.40,5360255 ,7.60
1180,2008,81,The House Bunny,70431655 ,48237389 ,68.50,22194266 ,31.50
1181,2008,82,Departures,69932387 ,1498210 ,2.10,68434177 ,97.90
1182,2008,83,The X Files: I Want to Believe,68369434 ,20982478 ,30.70,47386956 ,69.30
1183,2008,84,Star Wars: The Clone Wars,68282844 ,35161554 ,51.50,33121290 ,48.50
1184,2008,85,Street Kings,65572887 ,26418667 ,40.30,39154220 ,59.70
1185,2008,86,Space Chimps,64884277 ,30105968 ,46.40,34778309 ,53.60
1186,2008,87,The Bank Job,64822796 ,30060660 ,46.40,34762136 ,53.60
1187,2008,88,Baby Mama,64163648 ,60494212 ,94.30,3669436 ,5.70
1188,2008,89,Inkheart,62450361 ,17303424 ,27.70,45146937 ,72.30
1189,2008,90,Prom Night,57197876 ,43869350 ,76.70,13328526 ,23.30
1190,2008,91,The Eye,56964642 ,31418697 ,55.20,25545945 ,44.80
1191,2008,92,"Definitely, Maybe",55447968 ,32241649 ,58.10,23206319 ,41.90
1192,2008,93,Milk,54586584 ,31841299 ,58.30,22745285 ,41.70
1193,2008,94,Untraceable,52659594 ,28687835 ,54.50,23971759 ,45.50
1194,2008,95,College Road Trip,51549674 ,45610425 ,88.50,5939249 ,11.50
1195,2008,96,Defiance,51155219 ,28644813 ,56,22510406 ,44
1196,2008,97,Doubt,51018161 ,33446470 ,65.60,17571691 ,34.40
1197,2008,98,Meet Dave,50650079 ,11803254 ,23.30,38846825 ,76.70
1198,2008,99,The Women,50007546 ,26902075 ,53.80,23105471 ,46.20
1199,2008,100,Drillbit Taylor,49690625 ,32862104 ,66.10,16828521 ,33.90
